species	Continent
Acanthophoenix crinita	AfricaWAsia
Acanthophoenix rousselii	AfricaWAsia
Acanthophoenix rubra	AfricaWAsia
Acoelorrhaphe wrightii	Americas
Acrocomia aculeata	Americas
Acrocomia crispa	Americas
Acrocomia emensis	Americas
Acrocomia glaucescens	Americas
Acrocomia hassleri	Americas
Acrocomia intumescens	Americas
Acrocomia media	Americas
Acrocomia totai	Americas
Actinokentia divaricata	EAsiaPacific
Actinokentia huerlimannii	EAsiaPacific
Actinorhytis calapparia	EAsiaPacific
Adonidia dransfieldii	EAsiaPacific
Adonidia merrillii	EAsiaPacific
Aiphanes acanthophylla	Americas
Aiphanes acaulis	Americas
Aiphanes argos	Americas
Aiphanes bicornis	Americas
Aiphanes buenaventurae	Americas
Aiphanes chiribogensis	Americas
Aiphanes concinna	Americas
Aiphanes deltoidea	Americas
Aiphanes duquei	Americas
Aiphanes eggersii	Americas
Aiphanes erinacea	Americas
Aiphanes gelatinosa	Americas
Aiphanes graminifolia	Americas
Aiphanes grandis	Americas
Aiphanes hirsuta	Americas
Aiphanes horrida	Americas
Aiphanes killipii	Americas
Aiphanes leiostachys	Americas
Aiphanes lindeniana	Americas
Aiphanes linearis	Americas
Aiphanes macroloba	Americas
Aiphanes minima	Americas
Aiphanes multiplex	Americas
Aiphanes parvifolia	Americas
Aiphanes pilaris	Americas
Aiphanes simplex	Americas
Aiphanes spicata	Americas
Aiphanes tricuspidata	Americas
Aiphanes truncata	Americas
Aiphanes ulei	Americas
Aiphanes verrucosa	Americas
Aiphanes weberbaueri	Americas
Allagoptera arenaria	Americas
Allagoptera brevicalyx	Americas
Allagoptera campestris	Americas
Allagoptera caudescens	Americas
Allagoptera leucocalyx	Americas
Allagoptera robusta	Americas
Ammandra decasperma	Americas
Aphandra natalia	Americas
Archontophoenix alexandrae	EAsiaPacific
Archontophoenix cunninghamiana	EAsiaPacific
Archontophoenix maxima	EAsiaPacific
Archontophoenix myolensis	EAsiaPacific
Archontophoenix purpurea	EAsiaPacific
Archontophoenix tuckeri	EAsiaPacific
Areca abdulrahmanii	EAsiaPacific
Areca ahmadii	EAsiaPacific
Areca andersonii	EAsiaPacific
Areca arundinacea	EAsiaPacific
Areca bakeri	EAsiaPacific
Areca brachypoda	EAsiaPacific
Areca caliso	EAsiaPacific
Areca camarinensis	EAsiaPacific
Areca catechu	EAsiaPacific
Areca chaiana	EAsiaPacific
Areca churchii	EAsiaPacific
Areca concinna	EAsiaPacific
Areca congesta	EAsiaPacific
Areca costulata	EAsiaPacific
Areca dayung	EAsiaPacific
Areca dransfieldii	EAsiaPacific
Areca furcata	EAsiaPacific
Areca gurita	EAsiaPacific
Areca hutchinsoniana	EAsiaPacific
Areca insignis	EAsiaPacific
Areca ipot	EAsiaPacific
Areca jokowi	EAsiaPacific
Areca jugahpunya	EAsiaPacific
Areca kinabaluensis	EAsiaPacific
Areca klingkangensis	EAsiaPacific
Areca laosensis	EAsiaPacific
Areca ledermanniana	EAsiaPacific
Areca macrocalyx	EAsiaPacific
Areca mandacanii	EAsiaPacific
Areca minuta	EAsiaPacific
Areca mogeana	EAsiaPacific
Areca montana	EAsiaPacific
Areca novohibernica	EAsiaPacific
Areca oxycarpa	EAsiaPacific
Areca parens	EAsiaPacific
Areca rheophytica	EAsiaPacific
Areca ridleyana	EAsiaPacific
Areca riparia	EAsiaPacific
Areca songthanhensis	EAsiaPacific
Areca subacaulis	EAsiaPacific
Areca triandra	EAsiaPacific
Areca triginticollina	EAsiaPacific
Areca tunku	EAsiaPacific
Areca unipa	EAsiaPacific
Areca vestiaria	EAsiaPacific
Areca vidaliana	EAsiaPacific
Areca whitfordii	EAsiaPacific
Arenga australasica	EAsiaPacific
Arenga brevipes	EAsiaPacific
Arenga caudata	EAsiaPacific
Arenga distincta	EAsiaPacific
Arenga engleri	EAsiaPacific
Arenga hastata	EAsiaPacific
Arenga hookeriana	EAsiaPacific
Arenga listeri	EAsiaPacific
Arenga longicarpa	EAsiaPacific
Arenga longipes	EAsiaPacific
Arenga micrantha	EAsiaPacific
Arenga microcarpa	EAsiaPacific
Arenga mindorensis	EAsiaPacific
Arenga obtusifolia	EAsiaPacific
Arenga pinnata	EAsiaPacific
Arenga plicata	EAsiaPacific
Arenga porphyrocarpa	EAsiaPacific
Arenga retroflorescens	EAsiaPacific
Arenga ryukyuensis	EAsiaPacific
Arenga talamauensis	EAsiaPacific
Arenga tremula	EAsiaPacific
Arenga undulatifolia	EAsiaPacific
Arenga westerhoutii	EAsiaPacific
Arenga wightii	EAsiaPacific
Asterogyne guianensis	Americas
Asterogyne martiana	Americas
Asterogyne ramosa	Americas
Asterogyne spicata	Americas
Asterogyne yaracuyense	Americas
Astrocaryum acaule	Americas
Astrocaryum aculeatissimum	Americas
Astrocaryum aculeatum	Americas
Astrocaryum alatum	Americas
Astrocaryum arenarium	Americas
Astrocaryum campestre	Americas
Astrocaryum carnosum	Americas
Astrocaryum chambira	Americas
Astrocaryum chonta	Americas
Astrocaryum ciliatum	Americas
Astrocaryum confertum	Americas
Astrocaryum echinatum	Americas
Astrocaryum faranae	Americas
Astrocaryum farinosum	Americas
Astrocaryum ferrugineum	Americas
Astrocaryum giganteum	Americas
Astrocaryum gratum	Americas
Astrocaryum huaimi	Americas
Astrocaryum huicungo	Americas
Astrocaryum jauari	Americas
Astrocaryum javarense	Americas
Astrocaryum macrocalyx	Americas
Astrocaryum malybo	Americas
Astrocaryum mexicanum	Americas
Astrocaryum minus	Americas
Astrocaryum murumuru	Americas
Astrocaryum paramaca	Americas
Astrocaryum perangustatum	Americas
Astrocaryum rodriguesii	Americas
Astrocaryum sciophilum	Americas
Astrocaryum scopatum	Americas
Astrocaryum sociale	Americas
Astrocaryum standleyanum	Americas
Astrocaryum triandrum	Americas
Astrocaryum tucuma	Americas
Astrocaryum ulei	Americas
Astrocaryum urostachys	Americas
Astrocaryum vulgare	Americas
Attalea allenii	Americas
Attalea amygdalina	Americas
Attalea amylacea	Americas
Attalea anisitsiana	Americas
Attalea apoda	Americas
Attalea attaleoides	Americas
Attalea barreirensis	Americas
Attalea bassleriana	Americas
Attalea brasiliensis	Americas
Attalea brejinhoensis	Americas
Attalea burretiana	Americas
Attalea butyracea	Americas
Attalea camopiensis	Americas
Attalea cephalotus	Americas
Attalea cohune	Americas
Attalea colenda	Americas
Attalea compta	Americas
Attalea crassispatha	Americas
Attalea cuatrecasasiana	Americas
Attalea dahlgreniana	Americas
Attalea degranvillei	Americas
Attalea dubia	Americas
Attalea eichleri	Americas
Attalea exigua	Americas
Attalea fairchildensis	Americas
Attalea funifera	Americas
Attalea geraensis	Americas
Attalea guacuyule	Americas
Attalea guianensis	Americas
Attalea hoehnei	Americas
Attalea huebneri	Americas
Attalea humilis	Americas
Attalea iguadummat	Americas
Attalea insignis	Americas
Attalea kewensis	Americas
Attalea lauromuelleriana	Americas
Attalea leandroana	Americas
Attalea luetzelburgii	Americas
Attalea macrolepis	Americas
Attalea magdalenica	Americas
Attalea maracaibensis	Americas
Attalea maripa	Americas
Attalea maripensis	Americas
Attalea microcarpa	Americas
Attalea moorei	Americas
Attalea nucifera	Americas
Attalea oleifera	Americas
Attalea osmantha	Americas
Attalea pacensis	Americas
Attalea peruviana	Americas
Attalea phalerata	Americas
Attalea pindobassu	Americas
Attalea plowmanii	Americas
Attalea princeps	Americas
Attalea racemosa	Americas
Attalea rostrata	Americas
Attalea salazarii	Americas
Attalea salvadorensis	Americas
Attalea seabrensis	Americas
Attalea septuagenata	Americas
Attalea speciosa	Americas
Attalea spectabilis	Americas
Attalea tessmannii	Americas
Attalea vitrivir	Americas
Attalea weberbaueri	Americas
Attalea wesselsboeri	Americas
Bactris acanthocarpa	Americas
Bactris acanthocarpoides	Americas
Bactris ana-juliae	Americas
Bactris aubletiana	Americas
Bactris bahiensis	Americas
Bactris balanophora	Americas
Bactris barronis	Americas
Bactris bidentula	Americas
Bactris bifida	Americas
Bactris brongniartii	Americas
Bactris campestris	Americas
Bactris caryotifolia	Americas
Bactris caudata	Americas
Bactris charnleyae	Americas
Bactris chaveziae	Americas
Bactris chocoensis	Americas
Bactris coloniata	Americas
Bactris coloradonis	Americas
Bactris concinna	Americas
Bactris constanciae	Americas
Bactris corossilla	Americas
Bactris cubensis	Americas
Bactris cuspidata	Americas
Bactris dianeura	Americas
Bactris elegans	Americas
Bactris faucium	Americas
Bactris ferruginea	Americas
Bactris fissifrons	Americas
Bactris gasipaes	Americas
Bactris gastoniana	Americas
Bactris glandulosa	Americas
Bactris glassmanii	Americas
Bactris glaucescens	Americas
Bactris gracilior	Americas
Bactris grayumii	Americas
Bactris guineensis	Americas
Bactris halmoorei	Americas
Bactris hatschbachii	Americas
Bactris herrerana	Americas
Bactris hirta	Americas
Bactris horridispatha	Americas
Bactris jamaicana	Americas
Bactris killipii	Americas
Bactris kunorum	Americas
Bactris longiseta	Americas
Bactris macroacantha	Americas
Bactris major	Americas
Bactris manriquei	Americas
Bactris maraja	Americas
Bactris martiana	Americas
Bactris mexicana	Americas
Bactris militaris	Americas
Bactris nancibaensis	Americas
Bactris obovata	Americas
Bactris oligocarpa	Americas
Bactris oligoclada	Americas
Bactris panamensis	Americas
Bactris pickelii	Americas
Bactris pilosa	Americas
Bactris pliniana	Americas
Bactris plumeriana	Americas
Bactris polystachya	Americas
Bactris ptariana	Americas
Bactris rhaphidacantha	Americas
Bactris riparia	Americas
Bactris rostrata	Americas
Bactris schultesii	Americas
Bactris setiflora	Americas
Bactris setosa	Americas
Bactris setulosa	Americas
Bactris simplicifrons	Americas
Bactris soeiroana	Americas
Bactris sphaerocarpa	Americas
Bactris syagroides	Americas
Bactris tefensis	Americas
Bactris timbuiensis	Americas
Bactris tomentosa	Americas
Bactris turbinocarpa	Americas
Bactris vulgaris	Americas
Balaka diffusa	EAsiaPacific
Balaka insularis	Americas
Balaka longirostris	EAsiaPacific
Balaka macrocarpa	EAsiaPacific
Balaka microcarpa	EAsiaPacific
Balaka pauciflora	EAsiaPacific
Balaka samoensis	Americas
Balaka seemannii	EAsiaPacific
Balaka streptostachys	EAsiaPacific
Balaka tahitensis	Americas
Barcella odora	Americas
Basselinia deplanchei	EAsiaPacific
Basselinia eriostachys	EAsiaPacific
Basselinia favieri	EAsiaPacific
Basselinia glabrata	EAsiaPacific
Basselinia gracilis	EAsiaPacific
Basselinia humboldtiana	EAsiaPacific
Basselinia iterata	EAsiaPacific
Basselinia moorei	EAsiaPacific
Basselinia pancheri	EAsiaPacific
Basselinia porphyrea	EAsiaPacific
Basselinia sordida	EAsiaPacific
Basselinia tomentosa	EAsiaPacific
Basselinia velutina	EAsiaPacific
Basselinia vestita	EAsiaPacific
Beccariophoenix alfredii	AfricaWAsia
Beccariophoenix fenestralis	AfricaWAsia
Beccariophoenix madagascariensis	AfricaWAsia
Bentinckia condapanna	EAsiaPacific
Bentinckia nicobarica	EAsiaPacific
Bismarckia nobilis	AfricaWAsia
Borassodendron borneense	EAsiaPacific
Borassodendron machadonis	EAsiaPacific
Borassus aethiopum	AfricaWAsia
Borassus akeassii	AfricaWAsia
Borassus flabellifer	AfricaWAsia
Borassus heineanus	EAsiaPacific
Borassus madagascariensis	AfricaWAsia
Brahea aculeata	Americas
Brahea armata	Americas
Brahea brandegeei	Americas
Brahea calcarea	Americas
Brahea decumbens	Americas
Brahea dulcis	Americas
Brahea edulis	Americas
Brahea moorei	Americas
Brahea pimo	Americas
Brahea salvadorensis	Americas
Brahea sarukhanii	Americas
Brassiophoenix drymophloeoides	EAsiaPacific
Brassiophoenix schumannii	EAsiaPacific
Burretiokentia dumasii	EAsiaPacific
Burretiokentia grandiflora	EAsiaPacific
Burretiokentia hapala	EAsiaPacific
Burretiokentia koghiensis	EAsiaPacific
Burretiokentia vieillardii	EAsiaPacific
Butia archeri	Americas
Butia arenicola	Americas
Butia campicola	Americas
Butia capitata	Americas
Butia catarinensis	Americas
Butia eriospatha	Americas
Butia exilata	Americas
Butia exospadix	Americas
Butia lallemantii	Americas
Butia lepidotispatha	Americas
Butia leptospatha	Americas
Butia marmorii	Americas
Butia matogrossensis	Americas
Butia microspadix	Americas
Butia noblickii	Americas
Butia odorata	Americas
Butia paraguayensis	Americas
Butia poni	Americas
Butia pubispatha	Americas
Butia purpurascens	Americas
Butia witeckii	Americas
Butia yatay	Americas
Calamus acamptostachys	EAsiaPacific
Calamus acanthochlamys	EAsiaPacific
Calamus acanthophyllus	EAsiaPacific
Calamus acanthospathus	EAsiaPacific
Calamus acaulis	EAsiaPacific
Calamus acehensis	EAsiaPacific
Calamus adspersus	EAsiaPacific
Calamus affinis	EAsiaPacific
Calamus aidae	EAsiaPacific
Calamus albidus	EAsiaPacific
Calamus albus	EAsiaPacific
Calamus altiscandens	EAsiaPacific
Calamus andamanicus	EAsiaPacific
Calamus angustifolius	EAsiaPacific
Calamus anomalus	EAsiaPacific
Calamus arborescens	EAsiaPacific
Calamus aruensis	EAsiaPacific
Calamus arugda	EAsiaPacific
Calamus ashtonii	EAsiaPacific
Calamus asperrimus	EAsiaPacific
Calamus asteracanthus	EAsiaPacific
Calamus ater	EAsiaPacific
Calamus australis	EAsiaPacific
Calamus axillaris	EAsiaPacific
Calamus bachmaensis	EAsiaPacific
Calamus bacularis	EAsiaPacific
Calamus badius	EAsiaPacific
Calamus baiyerensis	EAsiaPacific
Calamus balerensis	EAsiaPacific
Calamus balingensis	EAsiaPacific
Calamus banggiensis	EAsiaPacific
Calamus bankae	EAsiaPacific
Calamus baratangensis	EAsiaPacific
Calamus barbatus	EAsiaPacific
Calamus barfodii	EAsiaPacific
Calamus batanensis	EAsiaPacific
Calamus beccarii	EAsiaPacific
Calamus beguinii	EAsiaPacific
Calamus bicolor	EAsiaPacific
Calamus billitonensis	EAsiaPacific
Calamus bimanifer	EAsiaPacific
Calamus binnendijkii	EAsiaPacific
Calamus boniensis	EAsiaPacific
Calamus bousigonii	EAsiaPacific
Calamus brachypodus	EAsiaPacific
Calamus brandisii	EAsiaPacific
Calamus brevicaulis	EAsiaPacific
Calamus bulubabi	EAsiaPacific
Calamus burckianus	EAsiaPacific
Calamus burkillianus	EAsiaPacific
Calamus caesius	EAsiaPacific
Calamus calapparius	EAsiaPacific
Calamus calicarpus	EAsiaPacific
Calamus calospathus	EAsiaPacific
Calamus capillosus	EAsiaPacific
Calamus caryotoides	EAsiaPacific
Calamus castaneus	EAsiaPacific
Calamus cawa	EAsiaPacific
Calamus centralis	EAsiaPacific
Calamus ceratophorus	EAsiaPacific
Calamus cheirophyllus	EAsiaPacific
Calamus ciliaris	EAsiaPacific
Calamus clemensianus	EAsiaPacific
Calamus cockburnii	EAsiaPacific
Calamus collarifer	EAsiaPacific
Calamus compsostachys	EAsiaPacific
Calamus comptus	EAsiaPacific
Calamus concinnus	EAsiaPacific
Calamus concolor	EAsiaPacific
Calamus confusus	EAsiaPacific
Calamus conirostris	EAsiaPacific
Calamus conjugatus	EAsiaPacific
Calamus conspectus	EAsiaPacific
Calamus convallium	EAsiaPacific
Calamus corneri	EAsiaPacific
Calamus crassifolius	EAsiaPacific
Calamus crinitus	EAsiaPacific
Calamus cristatus	EAsiaPacific
Calamus croftii	EAsiaPacific
Calamus cumingianus	EAsiaPacific
Calamus curranii	EAsiaPacific
Calamus cuthbertsonii	EAsiaPacific
Calamus daemonoropoides	EAsiaPacific
Calamus dasyacanthus	EAsiaPacific
Calamus deerratus	AfricaWAsia
Calamus delicatulus	EAsiaPacific
Calamus densiflorus	EAsiaPacific
Calamus depauperatus	EAsiaPacific
Calamus depressiusculus	EAsiaPacific
Calamus dianbaiensis	EAsiaPacific
Calamus didymocarpus	EAsiaPacific
Calamus didymophyllus	EAsiaPacific
Calamus diepenhorstii	EAsiaPacific
Calamus digitatus	EAsiaPacific
Calamus dilaceratus	EAsiaPacific
Calamus dioicus	EAsiaPacific
Calamus discolor	EAsiaPacific
Calamus distentus	EAsiaPacific
Calamus divaricatus	EAsiaPacific
Calamus dongnaiensis	EAsiaPacific
Calamus draco	EAsiaPacific
Calamus dracunculus	EAsiaPacific
Calamus dumetosus	EAsiaPacific
Calamus egregius	EAsiaPacific
Calamus elongatus	EAsiaPacific
Calamus equestris	EAsiaPacific
Calamus erectus	EAsiaPacific
Calamus erinaceus	EAsiaPacific
Calamus erioacanthus	EAsiaPacific
Calamus erythrocarpus	EAsiaPacific
Calamus essigii	EAsiaPacific
Calamus eugenei	EAsiaPacific
Calamus evansii	EAsiaPacific
Calamus exilis	EAsiaPacific
Calamus fertilis	EAsiaPacific
Calamus filipendulus	EAsiaPacific
Calamus filispadix	EAsiaPacific
Calamus fissilis	EAsiaPacific
Calamus fissus	EAsiaPacific
Calamus flabellatus	EAsiaPacific
Calamus flagellum	EAsiaPacific
Calamus flexilis	EAsiaPacific
Calamus floribundus	EAsiaPacific
Calamus forbesii	EAsiaPacific
Calamus formicarius	EAsiaPacific
Calamus formosanus	EAsiaPacific
Calamus foxworthyi	EAsiaPacific
Calamus gamblei	EAsiaPacific
Calamus geniculatus	EAsiaPacific
Calamus georgei	EAsiaPacific
Calamus gibbsianus	EAsiaPacific
Calamus glaucescens	EAsiaPacific
Calamus godefroyi	EAsiaPacific
Calamus gonospermus	EAsiaPacific
Calamus gracilipes	EAsiaPacific
Calamus gracilis	EAsiaPacific
Calamus grandifolius	EAsiaPacific
Calamus grandis	EAsiaPacific
Calamus griseus	EAsiaPacific
Calamus guruba	EAsiaPacific
Calamus hallierianus	EAsiaPacific
Calamus halmaherensis	EAsiaPacific
Calamus harmandii	EAsiaPacific
Calamus heatubunii	EAsiaPacific
Calamus helferianus	EAsiaPacific
Calamus henryanus	EAsiaPacific
Calamus heteracanthus	EAsiaPacific
Calamus heteroideus	EAsiaPacific
Calamus hirsutus	EAsiaPacific
Calamus holttumii	EAsiaPacific
Calamus hookerianus	EAsiaPacific
Calamus horridus	EAsiaPacific
Calamus hukaungensis	EAsiaPacific
Calamus inermis	EAsiaPacific
Calamus ingens	EAsiaPacific
Calamus inops	EAsiaPacific
Calamus insignis	EAsiaPacific
Calamus interruptus	EAsiaPacific
Calamus jacobsii	EAsiaPacific
Calamus javensis	EAsiaPacific
Calamus jenkinsianus	EAsiaPacific
Calamus jenningsianus	EAsiaPacific
Calamus johndransfieldii	EAsiaPacific
Calamus johnsii	EAsiaPacific
Calamus kampucheaensis	EAsiaPacific
Calamus kandariensis	EAsiaPacific
Calamus karnatakensis	EAsiaPacific
Calamus karuensis	EAsiaPacific
Calamus katikii	EAsiaPacific
Calamus kebariensis	EAsiaPacific
Calamus kiahii	EAsiaPacific
Calamus kingianus	EAsiaPacific
Calamus kjellbergii	EAsiaPacific
Calamus klossii	EAsiaPacific
Calamus komsaryi	EAsiaPacific
Calamus kontumensis	EAsiaPacific
Calamus koordersianus	EAsiaPacific
Calamus korthalsii	EAsiaPacific
Calamus kostermansii	EAsiaPacific
Calamus kunstleri	EAsiaPacific
Calamus kurzianus	EAsiaPacific
Calamus lakshmanae	EAsiaPacific
Calamus lambirensis	EAsiaPacific
Calamus lamprolepis	EAsiaPacific
Calamus laoensis	EAsiaPacific
Calamus lateralis	EAsiaPacific
Calamus latifolius	EAsiaPacific
Calamus lauterbachii	EAsiaPacific
Calamus laxissimus	EAsiaPacific
Calamus leiocaulis	EAsiaPacific
Calamus leloi	EAsiaPacific
Calamus leptopus	EAsiaPacific
Calamus leptospadix	EAsiaPacific
Calamus leptostachys	EAsiaPacific
Calamus lewisianus	EAsiaPacific
Calamus lobbianus	EAsiaPacific
Calamus loherianus	EAsiaPacific
Calamus longibracteatus	EAsiaPacific
Calamus longipes	EAsiaPacific
Calamus longipinna	EAsiaPacific
Calamus longisetus	EAsiaPacific
Calamus longispatha	EAsiaPacific
Calamus longispinosus	EAsiaPacific
Calamus longistipes	EAsiaPacific
Calamus lucysmithiae	EAsiaPacific
Calamus luteus	EAsiaPacific
Calamus macrochlamys	EAsiaPacific
Calamus macrophyllus	EAsiaPacific
Calamus macropterus	EAsiaPacific
Calamus macrorhynchus	EAsiaPacific
Calamus macrosphaerion	EAsiaPacific
Calamus maculatus	EAsiaPacific
Calamus maiadum	EAsiaPacific
Calamus malawaliensis	EAsiaPacific
Calamus manan	EAsiaPacific
Calamus manii	EAsiaPacific
Calamus manillensis	EAsiaPacific
Calamus marginatus	EAsiaPacific
Calamus mattanensis	EAsiaPacific
Calamus maturbongsii	EAsiaPacific
Calamus megalocarpus	EAsiaPacific
Calamus megaphyllus	EAsiaPacific
Calamus meghalayensis	EAsiaPacific
Calamus melanacanthos	EAsiaPacific
Calamus melanochaetes	EAsiaPacific
Calamus melanochrous	EAsiaPacific
Calamus melanoloma	EAsiaPacific
Calamus melanorhynchus	EAsiaPacific
Calamus merrillii	EAsiaPacific
Calamus metzianus	EAsiaPacific
Calamus micracanthus	EAsiaPacific
Calamus micranthus	EAsiaPacific
Calamus microsphaerion	EAsiaPacific
Calamus microstachys	EAsiaPacific
Calamus minahassae	EAsiaPacific
Calamus minor	EAsiaPacific
Calamus minutus	EAsiaPacific
Calamus mirabilis	EAsiaPacific
Calamus mitis	EAsiaPacific
Calamus modestus	EAsiaPacific
Calamus mogeae	EAsiaPacific
Calamus mogeanus	EAsiaPacific
Calamus mollis	EAsiaPacific
Calamus mollispinus	EAsiaPacific
Calamus monticola	EAsiaPacific
Calamus moorei	EAsiaPacific
Calamus moorhousei	EAsiaPacific
Calamus moseleyanus	EAsiaPacific
Calamus moszkowskianus	EAsiaPacific
Calamus moti	EAsiaPacific
Calamus muelleri	EAsiaPacific
Calamus multispicatus	EAsiaPacific
Calamus muricatus	EAsiaPacific
Calamus myriacanthus	EAsiaPacific
Calamus myrianthus	EAsiaPacific
Calamus nagbettai	EAsiaPacific
Calamus nanduensis	EAsiaPacific
Calamus nannostachys	EAsiaPacific
Calamus nanodendron	EAsiaPacific
Calamus nematospadix	EAsiaPacific
Calamus nicobaricus	EAsiaPacific
Calamus nicolai	EAsiaPacific
Calamus nielsenii	EAsiaPacific
Calamus niger	EAsiaPacific
Calamus nitidus	EAsiaPacific
Calamus novae-georgii	EAsiaPacific
Calamus nuichuaensis	EAsiaPacific
Calamus oblatus	EAsiaPacific
Calamus oblongus	EAsiaPacific
Calamus occidentalis	EAsiaPacific
Calamus ochrolepis	EAsiaPacific
Calamus ocreatus	EAsiaPacific
Calamus oligolepis	EAsiaPacific
Calamus oligophyllus	EAsiaPacific
Calamus oligostachys	EAsiaPacific
Calamus optimus	EAsiaPacific
Calamus oresbius	EAsiaPacific
Calamus ornatus	EAsiaPacific
Calamus orthostachyus	EAsiaPacific
Calamus ovoideus	EAsiaPacific
Calamus oxleyanus	EAsiaPacific
Calamus oxycarpus	EAsiaPacific
Calamus oxycoccus	EAsiaPacific
Calamus pachypus	EAsiaPacific
Calamus pachyrostris	EAsiaPacific
Calamus pachystemonus	EAsiaPacific
Calamus padangensis	EAsiaPacific
Calamus palembanicus	EAsiaPacific
Calamus pandanosmus	EAsiaPacific
Calamus pannosus	EAsiaPacific
Calamus papuanus	EAsiaPacific
Calamus papyraceus	EAsiaPacific
Calamus parutan	EAsiaPacific
Calamus parvifructus	EAsiaPacific
Calamus parvulus	EAsiaPacific
Calamus paspalanthus	EAsiaPacific
Calamus paulii	EAsiaPacific
Calamus pedicellaris	EAsiaPacific
Calamus pedicellatus	EAsiaPacific
Calamus penicillatus	EAsiaPacific
Calamus perakensis	EAsiaPacific
Calamus peregrinus	EAsiaPacific
Calamus periacanthus	EAsiaPacific
Calamus pholidostachys	EAsiaPacific
Calamus pilosellus	EAsiaPacific
Calamus pilosissimus	EAsiaPacific
Calamus pintaudii	EAsiaPacific
Calamus plagiocyclus	EAsiaPacific
Calamus platyspathus	EAsiaPacific
Calamus plicatus	EAsiaPacific
Calamus poensis	EAsiaPacific
Calamus pogonacanthus	EAsiaPacific
Calamus pogonotium	EAsiaPacific
Calamus poilanei	EAsiaPacific
Calamus politus	EAsiaPacific
Calamus polycladus	EAsiaPacific
Calamus polystachys	EAsiaPacific
Calamus pseudoconcolor	EAsiaPacific
Calamus pseudotenuis	EAsiaPacific
Calamus pseudozebrinus	EAsiaPacific
Calamus psilocladus	EAsiaPacific
Calamus pumilus	EAsiaPacific
Calamus pycnocarpus	EAsiaPacific
Calamus pygmaeus	EAsiaPacific
Calamus quangngaiensis	EAsiaPacific
Calamus radiatus	EAsiaPacific
Calamus radicalis	EAsiaPacific
Calamus radulosus	EAsiaPacific
Calamus rarispinosus	EAsiaPacific
Calamus reinwardtii	EAsiaPacific
Calamus reticulatus	EAsiaPacific
Calamus retroflexus	EAsiaPacific
Calamus reyesianus	EAsiaPacific
Calamus rhabdocladus	EAsiaPacific
Calamus rheedei	EAsiaPacific
Calamus rhomboideus	EAsiaPacific
Calamus rhytidomus	EAsiaPacific
Calamus ridleyanus	EAsiaPacific
Calamus riedelianus	EAsiaPacific
Calamus robinsonianus	EAsiaPacific
Calamus rotang	EAsiaPacific
Calamus ruber	EAsiaPacific
Calamus rudentum	EAsiaPacific
Calamus rugosus	EAsiaPacific
Calamus rumphii	EAsiaPacific
Calamus ruptilis	EAsiaPacific
Calamus ruvidus	EAsiaPacific
Calamus sabalensis	EAsiaPacific
Calamus sabensis	EAsiaPacific
Calamus sabut	EAsiaPacific
Calamus salicifolius	EAsiaPacific
Calamus samian	EAsiaPacific
Calamus sarasinorum	EAsiaPacific
Calamus sarawakensis	EAsiaPacific
Calamus sashae	EAsiaPacific
Calamus scabridulus	EAsiaPacific
Calamus scabrispathus	EAsiaPacific
Calamus scapigerus	EAsiaPacific
Calamus schistoacanthus	EAsiaPacific
Calamus schlechteri	EAsiaPacific
Calamus schlechterianus	EAsiaPacific
Calamus scipionum	EAsiaPacific
Calamus scleracanthus	EAsiaPacific
Calamus sedens	EAsiaPacific
Calamus sedisspirituum	EAsiaPacific
Calamus sekundurensis	EAsiaPacific
Calamus senalingensis	EAsiaPacific
Calamus sepal	EAsiaPacific
Calamus seriatus	EAsiaPacific
Calamus serpentinus	EAsiaPacific
Calamus serrulatus	EAsiaPacific
Calamus siberutensis	EAsiaPacific
Calamus simplex	EAsiaPacific
Calamus singalanus	EAsiaPacific
Calamus siphonospathus	EAsiaPacific
Calamus sordidus	EAsiaPacific
Calamus spanostachys	EAsiaPacific
Calamus sparsiflorus	EAsiaPacific
Calamus spectatissimus	EAsiaPacific
Calamus spiculifer	EAsiaPacific
Calamus spinifolius	EAsiaPacific
Calamus spinulinervis	EAsiaPacific
Calamus spiralis	EAsiaPacific
Calamus stenophyllus	EAsiaPacific
Calamus stolonifer	EAsiaPacific
Calamus suaveolens	EAsiaPacific
Calamus subangulatus	EAsiaPacific
Calamus sumbawensis	EAsiaPacific
Calamus superciliatus	EAsiaPacific
Calamus symphysipus	EAsiaPacific
Calamus takanensis	EAsiaPacific
Calamus tanakadatei	EAsiaPacific
Calamus temii	EAsiaPacific
Calamus tenompokensis	EAsiaPacific
Calamus tenuis	EAsiaPacific
Calamus tetradactyloides	EAsiaPacific
Calamus tetradactylus	EAsiaPacific
Calamus thwaitesii	EAsiaPacific
Calamus thysanolepis	EAsiaPacific
Calamus timorensis	EAsiaPacific
Calamus toli-toliensis	EAsiaPacific
Calamus trachycoleus	EAsiaPacific
Calamus treubianus	EAsiaPacific
Calamus trichrous	EAsiaPacific
Calamus tumidus	EAsiaPacific
Calamus unifarius	EAsiaPacific
Calamus unijugus	EAsiaPacific
Calamus urdanetanus	EAsiaPacific
Calamus ursinus	EAsiaPacific
Calamus uschdraweitianus	EAsiaPacific
Calamus usitatus	EAsiaPacific
Calamus validus	EAsiaPacific
Calamus vattayila	EAsiaPacific
Calamus verticillaris	EAsiaPacific
Calamus vestitus	EAsiaPacific
Calamus vidalianus	EAsiaPacific
Calamus viminalis	EAsiaPacific
Calamus vinosus	EAsiaPacific
Calamus viridissimus	EAsiaPacific
Calamus vitiensis	EAsiaPacific
Calamus walkeri	EAsiaPacific
Calamus wanggaii	EAsiaPacific
Calamus warburgii	EAsiaPacific
Calamus whitmorei	EAsiaPacific
Calamus wightii	EAsiaPacific
Calamus womersleyi	EAsiaPacific
Calamus wrightmyoensis	EAsiaPacific
Calamus wuliangshanensis	EAsiaPacific
Calamus yentuensis	EAsiaPacific
Calamus zebrinus	EAsiaPacific
Calamus zeylanicus	EAsiaPacific
Calamus zieckii	EAsiaPacific
Calamus zollingeri	EAsiaPacific
Calamus zonatus	EAsiaPacific
Calyptrocalyx albertisianus	EAsiaPacific
Calyptrocalyx amoenus	EAsiaPacific
Calyptrocalyx arfakianus	EAsiaPacific
Calyptrocalyx awa	EAsiaPacific
Calyptrocalyx caudiculatus	EAsiaPacific
Calyptrocalyx doxanthus	EAsiaPacific
Calyptrocalyx elegans	EAsiaPacific
Calyptrocalyx flabellatus	EAsiaPacific
Calyptrocalyx forbesii	EAsiaPacific
Calyptrocalyx geonomiformis	EAsiaPacific
Calyptrocalyx hollrungii	EAsiaPacific
Calyptrocalyx julianettii	EAsiaPacific
Calyptrocalyx lauterbachianus	EAsiaPacific
Calyptrocalyx laxiflorus	EAsiaPacific
Calyptrocalyx lepidotus	EAsiaPacific
Calyptrocalyx leptostachys	EAsiaPacific
Calyptrocalyx merrillianus	EAsiaPacific
Calyptrocalyx micholitzii	EAsiaPacific
Calyptrocalyx multifidus	EAsiaPacific
Calyptrocalyx pachystachys	EAsiaPacific
Calyptrocalyx pauciflorus	EAsiaPacific
Calyptrocalyx polyphyllus	EAsiaPacific
Calyptrocalyx pusillus	EAsiaPacific
Calyptrocalyx sessiliflorus	EAsiaPacific
Calyptrocalyx spicatus	EAsiaPacific
Calyptrocalyx yamutumene	EAsiaPacific
Calyptrogyne allenii	Americas
Calyptrogyne anomala	Americas
Calyptrogyne baudensis	Americas
Calyptrogyne coloradensis	Americas
Calyptrogyne condensata	Americas
Calyptrogyne costatifrons	Americas
Calyptrogyne deneversii	Americas
Calyptrogyne fortunensis	Americas
Calyptrogyne ghiesbreghtiana	Americas
Calyptrogyne herrerae	Americas
Calyptrogyne kunorum	Americas
Calyptrogyne osensis	Americas
Calyptrogyne panamensis	Americas
Calyptrogyne pubescens	Americas
Calyptrogyne sanblasensis	Americas
Calyptrogyne trichostachys	Americas
Calyptrogyne tutensis	Americas
Calyptronoma occidentalis	Americas
Calyptronoma plumeriana	Americas
Calyptronoma rivalis	Americas
Carpentaria acuminata	EAsiaPacific
Carpoxylon macrospermum	EAsiaPacific
Caryota alberti	EAsiaPacific
Caryota angustifolia	EAsiaPacific
Caryota cumingii	EAsiaPacific
Caryota kiriwongensis	EAsiaPacific
Caryota maxima	EAsiaPacific
Caryota mitis	EAsiaPacific
Caryota monostachya	EAsiaPacific
Caryota no	EAsiaPacific
Caryota obtusa	EAsiaPacific
Caryota ophiopellis	EAsiaPacific
Caryota rumphiana	EAsiaPacific
Caryota sympetala	EAsiaPacific
Caryota urens	EAsiaPacific
Caryota zebrina	EAsiaPacific
Ceroxylon alpinum	Americas
Ceroxylon amazonicum	Americas
Ceroxylon ceriferum	Americas
Ceroxylon echinulatum	Americas
Ceroxylon parvifrons	Americas
Ceroxylon parvum	Americas
Ceroxylon peruvianum	Americas
Ceroxylon pityrophyllum	Americas
Ceroxylon quindiuense	Americas
Ceroxylon sasaimae	Americas
Ceroxylon ventricosum	Americas
Ceroxylon vogelianum	Americas
Chamaedorea adscendens	Americas
Chamaedorea allenii	Americas
Chamaedorea alternans	Americas
Chamaedorea amabilis	Americas
Chamaedorea anemophila	Americas
Chamaedorea angustisecta	Americas
Chamaedorea arenbergiana	Americas
Chamaedorea atrovirens	Americas
Chamaedorea benziei	Americas
Chamaedorea binderi	Americas
Chamaedorea brachyclada	Americas
Chamaedorea brachypoda	Americas
Chamaedorea carchensis	Americas
Chamaedorea castillo-montii	Americas
Chamaedorea cataractarum	Americas
Chamaedorea christinae	Americas
Chamaedorea correae	Americas
Chamaedorea costaricana	Americas
Chamaedorea crucensis	Americas
Chamaedorea dammeriana	Americas
Chamaedorea deckeriana	Americas
Chamaedorea deneversiana	Americas
Chamaedorea elatior	Americas
Chamaedorea elegans	Americas
Chamaedorea ernesti-augusti	Americas
Chamaedorea falcifera	Americas
Chamaedorea foveata	Americas
Chamaedorea fractiflexa	Americas
Chamaedorea fragrans	Americas
Chamaedorea frondosa	Americas
Chamaedorea geonomiformis	Americas
Chamaedorea glaucifolia	Americas
Chamaedorea graminifolia	Americas
Chamaedorea guntheriana	Americas
Chamaedorea hodelii	Americas
Chamaedorea hooperiana	Americas
Chamaedorea ibarrae	Americas
Chamaedorea incrustata	Americas
Chamaedorea keelerorum	Americas
Chamaedorea klotzschiana	Americas
Chamaedorea lehmannii	Americas
Chamaedorea liebmannii	Americas
Chamaedorea linearis	Americas
Chamaedorea lucidifrons	Americas
Chamaedorea macrospadix	Americas
Chamaedorea matae	Americas
Chamaedorea metallica	Americas
Chamaedorea microphylla	Americas
Chamaedorea microspadix	Americas
Chamaedorea moliniana	Americas
Chamaedorea nationsiana	Americas
Chamaedorea neurochlamys	Americas
Chamaedorea nubium	Americas
Chamaedorea oblongata	Americas
Chamaedorea oreophila	Americas
Chamaedorea pachecoana	Americas
Chamaedorea palmeriana	Americas
Chamaedorea parvifolia	Americas
Chamaedorea parvisecta	Americas
Chamaedorea pauciflora	Americas
Chamaedorea pedunculata	Americas
Chamaedorea pinnatifrons	Americas
Chamaedorea piscifolia	Americas
Chamaedorea pittieri	Americas
Chamaedorea plumosa	Americas
Chamaedorea pochutlensis	Americas
Chamaedorea ponderosa	Americas
Chamaedorea pumila	Americas
Chamaedorea pygmaea	Americas
Chamaedorea queroana	Americas
Chamaedorea radicalis	Americas
Chamaedorea recurvata	Americas
Chamaedorea rhizomatosa	Americas
Chamaedorea ricardoi	Americas
Chamaedorea rigida	Americas
Chamaedorea robertii	Americas
Chamaedorea rojasiana	Americas
Chamaedorea rosibeliae	Americas
Chamaedorea rossteniorum	Americas
Chamaedorea sartorii	Americas
Chamaedorea scheryi	Americas
Chamaedorea schiedeana	Americas
Chamaedorea schippii	Americas
Chamaedorea seifrizii	Americas
Chamaedorea serpens	Americas
Chamaedorea simplex	Americas
Chamaedorea skutchii	Americas
Chamaedorea smithii	Americas
Chamaedorea stenocarpa	Americas
Chamaedorea stolonifera	Americas
Chamaedorea stricta	Americas
Chamaedorea subjectifolia	Americas
Chamaedorea tenerrima	Americas
Chamaedorea tepejilote	Americas
Chamaedorea tuerckheimii	Americas
Chamaedorea undulatifolia	Americas
Chamaedorea verapazensis	Americas
Chamaedorea verecunda	Americas
Chamaedorea volcanensis	Americas
Chamaedorea vulgata	Americas
Chamaedorea warscewiczii	Americas
Chamaedorea whitelockiana	Americas
Chamaedorea woodsoniana	Americas
Chamaedorea zamorae	Americas
Chamaerops humilis	AfricaWAsia
Chambeyronia lepidota	EAsiaPacific
Chambeyronia macrocarpa	EAsiaPacific
Chelyocarpus chuco	Americas
Chelyocarpus dianeurus	Americas
Chelyocarpus repens	Americas
Chelyocarpus ulei	Americas
Chuniophoenix hainanensis	EAsiaPacific
Chuniophoenix nana	EAsiaPacific
Clinosperma bracteale	EAsiaPacific
Clinosperma lanuginosa	EAsiaPacific
Clinosperma macrocarpa	EAsiaPacific
Clinosperma vaginata	EAsiaPacific
Clinostigma carolinense	EAsiaPacific
Clinostigma collegarum	EAsiaPacific
Clinostigma exorrhizum	EAsiaPacific
Clinostigma gronophyllum	EAsiaPacific
Clinostigma haerestigma	EAsiaPacific
Clinostigma harlandii	EAsiaPacific
Clinostigma onchorhynchum	Americas
Clinostigma ponapense	EAsiaPacific
Clinostigma samoense	Americas
Clinostigma savoryanum	EAsiaPacific
Clinostigma warburgii	Americas
Coccothrinax acunana	Americas
Coccothrinax alexandri	Americas
Coccothrinax alta	Americas
Coccothrinax argentata	Americas
Coccothrinax argentea	Americas
Coccothrinax baracoensis	Americas
Coccothrinax barbadensis	Americas
Coccothrinax bermudezii	Americas
Coccothrinax borhidiana	Americas
Coccothrinax boschiana	Americas
Coccothrinax camagueyana	Americas
Coccothrinax clarensis	Americas
Coccothrinax concolor	Americas
Coccothrinax crinita	Americas
Coccothrinax cupularis	Americas
Coccothrinax ekmanii	Americas
Coccothrinax elegans	Americas
Coccothrinax fagildei	Americas
Coccothrinax fragrans	Americas
Coccothrinax garciana	Americas
Coccothrinax gracilis	Americas
Coccothrinax guantanamensis	Americas
Coccothrinax gundlachii	Americas
Coccothrinax hioramii	Americas
Coccothrinax inaguensis	Americas
Coccothrinax jamaicensis	Americas
Coccothrinax jimenezii	Americas
Coccothrinax leonis	Americas
Coccothrinax litoralis	Americas
Coccothrinax macroglossa	Americas
Coccothrinax microphylla	Americas
Coccothrinax miraguama	Americas
Coccothrinax moaensis	Americas
Coccothrinax montana	Americas
Coccothrinax munizii	Americas
Coccothrinax muricata	Americas
Coccothrinax nipensis	Americas
Coccothrinax orientalis	Americas
Coccothrinax pauciramosa	Americas
Coccothrinax proctorii	Americas
Coccothrinax pseudorigida	Americas
Coccothrinax pumila	Americas
Coccothrinax readii	Americas
Coccothrinax rigida	Americas
Coccothrinax salvatoris	Americas
Coccothrinax saxicola	Americas
Coccothrinax scoparia	Americas
Coccothrinax spissa	Americas
Coccothrinax torrida	Americas
Coccothrinax trinitensis	Americas
Coccothrinax victorinii	Americas
Coccothrinax yunquensis	Americas
Coccothrinax yuraguana	Americas
Cocos nucifera	EAsiaPacific
Colpothrinax aphanopetala	Americas
Colpothrinax cookii	Americas
Colpothrinax wrightii	Americas
Copernicia alba	Americas
Copernicia baileyana	Americas
Copernicia berteroana	Americas
Copernicia brittonorum	Americas
Copernicia cowellii	Americas
Copernicia curbeloi	Americas
Copernicia curtissii	Americas
Copernicia ekmanii	Americas
Copernicia fallaensis	Americas
Copernicia gigas	Americas
Copernicia glabrescens	Americas
Copernicia hospita	Americas
Copernicia humicola	Americas
Copernicia longiglossa	Americas
Copernicia macroglossa	Americas
Copernicia molinetii	Americas
Copernicia oxycalyx	Americas
Copernicia prunifera	Americas
Copernicia rigida	Americas
Copernicia roigii	Americas
Copernicia tectorum	Americas
Copernicia yarey	Americas
Corypha lecomtei	EAsiaPacific
Corypha microclada	EAsiaPacific
Corypha taliera	EAsiaPacific
Corypha umbraculifera	EAsiaPacific
Corypha utan	EAsiaPacific
Cryosophila bartlettii	Americas
Cryosophila cookii	Americas
Cryosophila grayumii	Americas
Cryosophila guagara	Americas
Cryosophila kalbreyeri	Americas
Cryosophila macrocarpa	Americas
Cryosophila nana	Americas
Cryosophila stauracantha	Americas
Cryosophila warscewiczii	Americas
Cryosophila williamsii	Americas
Cyphokentia cerifera	EAsiaPacific
Cyphokentia macrostachya	EAsiaPacific
Cyphophoenix alba	EAsiaPacific
Cyphophoenix elegans	EAsiaPacific
Cyphophoenix fulcita	EAsiaPacific
Cyphophoenix nucele	EAsiaPacific
Cyphosperma balansae	EAsiaPacific
Cyphosperma naboutinense	EAsiaPacific
Cyphosperma tanga	EAsiaPacific
Cyphosperma trichospadix	EAsiaPacific
Cyphosperma voutmelense	EAsiaPacific
Cyrtostachys bakeri	EAsiaPacific
Cyrtostachys barbata	EAsiaPacific
Cyrtostachys elegans	EAsiaPacific
Cyrtostachys excelsa	EAsiaPacific
Cyrtostachys glauca	EAsiaPacific
Cyrtostachys loriae	EAsiaPacific
Cyrtostachys renda	EAsiaPacific
Deckenia nobilis	AfricaWAsia
Desmoncus chinantlensis	Americas
Desmoncus cirrhifer	Americas
Desmoncus costaricensis	Americas
Desmoncus giganteus	Americas
Desmoncus horridus	Americas
Desmoncus interjectus	Americas
Desmoncus kunarius	Americas
Desmoncus latisectus	Americas
Desmoncus leptoclonos	Americas
Desmoncus loretanus	Americas
Desmoncus madrensis	Americas
Desmoncus mitis	Americas
Desmoncus moorei	Americas
Desmoncus myriacanthos	Americas
Desmoncus obovoideus	Americas
Desmoncus orthacanthos	Americas
Desmoncus osensis	Americas
Desmoncus parvulus	Americas
Desmoncus polyacanthos	Americas
Desmoncus prunifer	Americas
Desmoncus pumilus	Americas
Desmoncus setosus	Americas
Desmoncus stans	Americas
Desmoncus vacivus	Americas
Dictyocaryum fuscum	Americas
Dictyocaryum lamarckianum	Americas
Dictyocaryum ptarianum	Americas
Dictyosperma album	AfricaWAsia
Dransfieldia micrantha	EAsiaPacific
Drymophloeus litigiosus	EAsiaPacific
Drymophloeus oliviformis	EAsiaPacific
Drymophloeus whitmeeanus	Americas
Dypsis acaulis	AfricaWAsia
Dypsis acuminum	AfricaWAsia
Dypsis albofarinosa	AfricaWAsia
Dypsis ambanjae	AfricaWAsia
Dypsis ambilaensis	AfricaWAsia
Dypsis ambositrae	AfricaWAsia
Dypsis andapae	AfricaWAsia
Dypsis andilamenensis	AfricaWAsia
Dypsis andrianatonga	AfricaWAsia
Dypsis angusta	AfricaWAsia
Dypsis angustifolia	AfricaWAsia
Dypsis anjae	AfricaWAsia
Dypsis ankaizinensis	AfricaWAsia
Dypsis ankirindro	AfricaWAsia
Dypsis antanambensis	AfricaWAsia
Dypsis aquatilis	AfricaWAsia
Dypsis arenarum	AfricaWAsia
Dypsis baronii	AfricaWAsia
Dypsis basilonga	AfricaWAsia
Dypsis beentjei	AfricaWAsia
Dypsis bejofo	AfricaWAsia
Dypsis bernieriana	AfricaWAsia
Dypsis betamponensis	AfricaWAsia
Dypsis betsimisarakae	AfricaWAsia
Dypsis boiviniana	AfricaWAsia
Dypsis bonsai	AfricaWAsia
Dypsis bosseri	AfricaWAsia
Dypsis brevicaulis	AfricaWAsia
Dypsis brittiana	AfricaWAsia
Dypsis cabadae	AfricaWAsia
Dypsis canaliculata	AfricaWAsia
Dypsis canescens	AfricaWAsia
Dypsis carlsmithii	AfricaWAsia
Dypsis catatiana	AfricaWAsia
Dypsis caudata	AfricaWAsia
Dypsis ceracea	AfricaWAsia
Dypsis commersoniana	AfricaWAsia
Dypsis concinna	AfricaWAsia
Dypsis confusa	AfricaWAsia
Dypsis cookei	AfricaWAsia
Dypsis coriacea	AfricaWAsia
Dypsis corniculata	AfricaWAsia
Dypsis coursii	AfricaWAsia
Dypsis crinita	AfricaWAsia
Dypsis culminis	AfricaWAsia
Dypsis curtisii	AfricaWAsia
Dypsis decaryi	AfricaWAsia
Dypsis decipiens	AfricaWAsia
Dypsis declivium	AfricaWAsia
Dypsis delicatula	AfricaWAsia
Dypsis digitata	AfricaWAsia
Dypsis dracaenoides	AfricaWAsia
Dypsis dransfieldii	AfricaWAsia
Dypsis elegans	AfricaWAsia
Dypsis eriostachys	AfricaWAsia
Dypsis faneva	AfricaWAsia
Dypsis fanjana	AfricaWAsia
Dypsis fasciculata	AfricaWAsia
Dypsis fibrosa	AfricaWAsia
Dypsis forficifolia	AfricaWAsia
Dypsis furcata	AfricaWAsia
Dypsis gautieri	AfricaWAsia
Dypsis glabrescens	AfricaWAsia
Dypsis gronophyllum	AfricaWAsia
Dypsis henrici	AfricaWAsia
Dypsis heteromorpha	AfricaWAsia
Dypsis heterophylla	AfricaWAsia
Dypsis hiarakae	AfricaWAsia
Dypsis hildebrandtii	AfricaWAsia
Dypsis hovomantsina	AfricaWAsia
Dypsis humbertii	AfricaWAsia
Dypsis humblotiana	AfricaWAsia
Dypsis humilis	AfricaWAsia
Dypsis ifanadianae	AfricaWAsia
Dypsis integra	AfricaWAsia
Dypsis intermedia	AfricaWAsia
Dypsis interrupta	AfricaWAsia
Dypsis jeremiei	AfricaWAsia
Dypsis jumelleana	AfricaWAsia
Dypsis laevis	AfricaWAsia
Dypsis lanceolata	AfricaWAsia
Dypsis lantzeana	AfricaWAsia
Dypsis lanuginosa	AfricaWAsia
Dypsis lastelliana	AfricaWAsia
Dypsis leptocheilos	AfricaWAsia
Dypsis leucomalla	AfricaWAsia
Dypsis ligulata	AfricaWAsia
Dypsis lilacina	AfricaWAsia
Dypsis linearis	AfricaWAsia
Dypsis lokohoensis	AfricaWAsia
Dypsis louvelii	AfricaWAsia
Dypsis lucens	AfricaWAsia
Dypsis lutea	AfricaWAsia
Dypsis lutescens	AfricaWAsia
Dypsis madagascariensis	AfricaWAsia
Dypsis mahia	AfricaWAsia
Dypsis makirae	AfricaWAsia
Dypsis malcomberi	AfricaWAsia
Dypsis mananjarensis	AfricaWAsia
Dypsis mangorensis	AfricaWAsia
Dypsis marojejyi	AfricaWAsia
Dypsis mcdonaldiana	AfricaWAsia
Dypsis metallica	AfricaWAsia
Dypsis minuta	AfricaWAsia
Dypsis mirabilis	AfricaWAsia
Dypsis mocquerysiana	AfricaWAsia
Dypsis monostachya	AfricaWAsia
Dypsis montana	AfricaWAsia
Dypsis moorei	AfricaWAsia
Dypsis nauseosa	AfricaWAsia
Dypsis nodifera	AfricaWAsia
Dypsis nossibensis	AfricaWAsia
Dypsis occidentalis	AfricaWAsia
Dypsis onilahensis	AfricaWAsia
Dypsis oreophila	AfricaWAsia
Dypsis oropedionis	AfricaWAsia
Dypsis ovobontsira	AfricaWAsia
Dypsis pachyramea	AfricaWAsia
Dypsis paludosa	AfricaWAsia
Dypsis pembana	AfricaWAsia
Dypsis perrieri	AfricaWAsia
Dypsis pervillei	AfricaWAsia
Dypsis pilulifera	AfricaWAsia
Dypsis pinnatifrons	AfricaWAsia
Dypsis plumosa	AfricaWAsia
Dypsis plurisecta	AfricaWAsia
Dypsis poivreana	AfricaWAsia
Dypsis prestoniana	AfricaWAsia
Dypsis procera	AfricaWAsia
Dypsis procumbens	AfricaWAsia
Dypsis psammophila	AfricaWAsia
Dypsis pulchella	AfricaWAsia
Dypsis pumila	AfricaWAsia
Dypsis pusilla	AfricaWAsia
Dypsis pustulata	AfricaWAsia
Dypsis rakotonasoloi	AfricaWAsia
Dypsis ramentacea	AfricaWAsia
Dypsis reflexa	AfricaWAsia
Dypsis remotiflora	AfricaWAsia
Dypsis rivularis	AfricaWAsia
Dypsis robusta	AfricaWAsia
Dypsis rosea	AfricaWAsia
Dypsis sahanofensis	AfricaWAsia
Dypsis saintelucei	AfricaWAsia
Dypsis sancta	AfricaWAsia
Dypsis sanctaemariae	AfricaWAsia
Dypsis scandens	AfricaWAsia
Dypsis schatzii	AfricaWAsia
Dypsis scottiana	AfricaWAsia
Dypsis serpentina	AfricaWAsia
Dypsis simianensis	AfricaWAsia
Dypsis singularis	AfricaWAsia
Dypsis soanieranae	AfricaWAsia
Dypsis spicata	AfricaWAsia
Dypsis subacaulis	AfricaWAsia
Dypsis tanalensis	AfricaWAsia
Dypsis tenuissima	AfricaWAsia
Dypsis thermarum	AfricaWAsia
Dypsis thiryana	AfricaWAsia
Dypsis thouarsiana	AfricaWAsia
Dypsis tokoravina	AfricaWAsia
Dypsis trapezoidea	AfricaWAsia
Dypsis tsaratananensis	AfricaWAsia
Dypsis tsaravoasira	AfricaWAsia
Dypsis turkii	AfricaWAsia
Dypsis utilis	AfricaWAsia
Dypsis viridis	AfricaWAsia
Dypsis vonitrandambo	AfricaWAsia
Elaeis guineensis	AfricaWAsia
Elaeis oleifera	Americas
Eleiodoxa conferta	EAsiaPacific
Eremospatha barendii	AfricaWAsia
Eremospatha cabrae	AfricaWAsia
Eremospatha cuspidata	AfricaWAsia
Eremospatha dransfieldii	AfricaWAsia
Eremospatha haullevilleana	AfricaWAsia
Eremospatha hookeri	AfricaWAsia
Eremospatha laurentii	AfricaWAsia
Eremospatha macrocarpa	AfricaWAsia
Eremospatha quinquecostulata	AfricaWAsia
Eremospatha tessmanniana	AfricaWAsia
Eremospatha wendlandiana	AfricaWAsia
Eugeissona ambigua	EAsiaPacific
Eugeissona brachystachys	EAsiaPacific
Eugeissona insignis	EAsiaPacific
Eugeissona minor	EAsiaPacific
Eugeissona tristis	EAsiaPacific
Eugeissona utilis	EAsiaPacific
Euterpe broadwayi	Americas
Euterpe catinga	Americas
Euterpe edulis	Americas
Euterpe longibracteata	Americas
Euterpe luminosa	Americas
Euterpe oleracea	Americas
Euterpe precatoria	Americas
Gaussia attenuata	Americas
Gaussia gomez-pompae	Americas
Gaussia maya	Americas
Gaussia princeps	Americas
Gaussia spirituana	Americas
Geonoma aspidiifolia	Americas
Geonoma baculifera	Americas
Geonoma bernalii	Americas
Geonoma braunii	Americas
Geonoma brenesii	Americas
Geonoma brongniartii	Americas
Geonoma calyptrogynoidea	Americas
Geonoma camana	Americas
Geonoma chlamydostachys	Americas
Geonoma chococola	Americas
Geonoma concinna	Americas
Geonoma concinnoidea	Americas
Geonoma congesta	Americas
Geonoma cuneata	Americas
Geonoma deneversii	Americas
Geonoma deversa	Americas
Geonoma dindoensis	Americas
Geonoma divisa	Americas
Geonoma elegans	Americas
Geonoma epetiolata	Americas
Geonoma euspatha	Americas
Geonoma ferruginea	Americas
Geonoma fosteri	Americas
Geonoma frontinensis	Americas
Geonoma galeanoae	Americas
Geonoma gentryi	Americas
Geonoma hollinensis	Americas
Geonoma hugonis	Americas
Geonoma interrupta	Americas
Geonoma lanata	Americas
Geonoma laxiflora	Americas
Geonoma lehmannii	Americas
Geonoma leptospadix	Americas
Geonoma longepedunculata	Americas
Geonoma longivaginata	Americas
Geonoma macrostachys	Americas
Geonoma maxima	Americas
Geonoma monospatha	Americas
Geonoma mooreana	Americas
Geonoma multisecta	Americas
Geonoma occidentalis	Americas
Geonoma oldemanii	Americas
Geonoma oligoclona	Americas
Geonoma operculata	Americas
Geonoma orbignyana	Americas
Geonoma paradoxa	Americas
Geonoma pauciflora	Americas
Geonoma peruviana	Americas
Geonoma pinnatifrons	Americas
Geonoma poeppigiana	Americas
Geonoma pohliana	Americas
Geonoma poiteauana	Americas
Geonoma sanmartinensis	Americas
Geonoma santanderensis	Americas
Geonoma schizocarpa	Americas
Geonoma schottiana	Americas
Geonoma scoparia	Americas
Geonoma simplicifrons	Americas
Geonoma spinescens	Americas
Geonoma stricta	Americas
Geonoma talamancana	Americas
Geonoma tenuissima	Americas
Geonoma triandra	Americas
Geonoma triglochin	Americas
Geonoma trigona	Americas
Geonoma umbraculiformis	Americas
Geonoma undata	Americas
Geonoma venosa	Americas
Guihaia argyrata	EAsiaPacific
Guihaia grossifibrosa	EAsiaPacific
Guihaia lancifolia	EAsiaPacific
Hedyscepe canterburyana	EAsiaPacific
Hemithrinax compacta	Americas
Hemithrinax ekmaniana	Americas
Hemithrinax rivularis	Americas
Heterospathe annectens	EAsiaPacific
Heterospathe arfakiana	EAsiaPacific
Heterospathe barfodii	EAsiaPacific
Heterospathe brevicaulis	EAsiaPacific
Heterospathe cagayanensis	EAsiaPacific
Heterospathe califrons	EAsiaPacific
Heterospathe clemensiae	EAsiaPacific
Heterospathe compsoclada	EAsiaPacific
Heterospathe delicatula	EAsiaPacific
Heterospathe dransfieldii	EAsiaPacific
Heterospathe elata	EAsiaPacific
Heterospathe elegans	EAsiaPacific
Heterospathe elmeri	EAsiaPacific
Heterospathe glabra	EAsiaPacific
Heterospathe glauca	EAsiaPacific
Heterospathe intermedia	EAsiaPacific
Heterospathe kajewskii	EAsiaPacific
Heterospathe ledermanniana	EAsiaPacific
Heterospathe lepidota	EAsiaPacific
Heterospathe longipes	Americas
Heterospathe macgregorii	EAsiaPacific
Heterospathe minor	EAsiaPacific
Heterospathe muelleriana	EAsiaPacific
Heterospathe negrosensis	EAsiaPacific
Heterospathe obriensis	EAsiaPacific
Heterospathe parviflora	EAsiaPacific
Heterospathe philippinensis	EAsiaPacific
Heterospathe phillipsii	EAsiaPacific
Heterospathe pilosa	EAsiaPacific
Heterospathe porcata	EAsiaPacific
Heterospathe pulchra	EAsiaPacific
Heterospathe pullenii	EAsiaPacific
Heterospathe ramulosa	EAsiaPacific
Heterospathe salomonensis	EAsiaPacific
Heterospathe scitula	EAsiaPacific
Heterospathe sensisi	EAsiaPacific
Heterospathe sibuyanensis	EAsiaPacific
Heterospathe sphaerocarpa	EAsiaPacific
Heterospathe trispatha	EAsiaPacific
Heterospathe uniformis	EAsiaPacific
Heterospathe woodfordiana	EAsiaPacific
Howea belmoreana	EAsiaPacific
Howea forsteriana	EAsiaPacific
Hydriastele affinis	EAsiaPacific
Hydriastele aprica	EAsiaPacific
Hydriastele beccariana	EAsiaPacific
Hydriastele beguinii	EAsiaPacific
Hydriastele biakensis	EAsiaPacific
Hydriastele boumae	EAsiaPacific
Hydriastele brassii	EAsiaPacific
Hydriastele cariosa	EAsiaPacific
Hydriastele carrii	EAsiaPacific
Hydriastele chaunostachys	EAsiaPacific
Hydriastele costata	EAsiaPacific
Hydriastele cyclopensis	EAsiaPacific
Hydriastele cylindrocarpa	EAsiaPacific
Hydriastele dransfieldii	EAsiaPacific
Hydriastele flabellata	EAsiaPacific
Hydriastele geelvinkiana	EAsiaPacific
Hydriastele gibbsiana	EAsiaPacific
Hydriastele gracilis	EAsiaPacific
Hydriastele hombronii	EAsiaPacific
Hydriastele kasesa	EAsiaPacific
Hydriastele kjellbergii	EAsiaPacific
Hydriastele ledermanniana	EAsiaPacific
Hydriastele lepidota	EAsiaPacific
Hydriastele longispatha	EAsiaPacific
Hydriastele lurida	EAsiaPacific
Hydriastele macrospadix	EAsiaPacific
Hydriastele manusii	EAsiaPacific
Hydriastele mayrii	EAsiaPacific
Hydriastele micrantha	EAsiaPacific
Hydriastele microcarpa	EAsiaPacific
Hydriastele microspadix	EAsiaPacific
Hydriastele moluccana	EAsiaPacific
Hydriastele montana	EAsiaPacific
Hydriastele nannostachys	EAsiaPacific
Hydriastele oxypetala	EAsiaPacific
Hydriastele palauensis	EAsiaPacific
Hydriastele pinangoides	EAsiaPacific
Hydriastele pleurocarpa	EAsiaPacific
Hydriastele procera	EAsiaPacific
Hydriastele ramsayi	EAsiaPacific
Hydriastele rheophytica	EAsiaPacific
Hydriastele rhopalocarpa	EAsiaPacific
Hydriastele rostrata	EAsiaPacific
Hydriastele sarasinorum	EAsiaPacific
Hydriastele selebica	EAsiaPacific
Hydriastele valida	EAsiaPacific
Hydriastele variabilis	EAsiaPacific
Hydriastele vitiensis	EAsiaPacific
Hydriastele wendlandiana	EAsiaPacific
Hyophorbe amaricaulis	AfricaWAsia
Hyophorbe indica	AfricaWAsia
Hyophorbe lagenicaulis	AfricaWAsia
Hyophorbe vaughanii	AfricaWAsia
Hyophorbe verschaffeltii	AfricaWAsia
Hyospathe elegans	Americas
Hyospathe frontinensis	Americas
Hyospathe macrorhachis	Americas
Hyospathe peruviana	Americas
Hyospathe pittieri	Americas
Hyospathe wendlandiana	Americas
Hyphaene compressa	AfricaWAsia
Hyphaene coriacea	AfricaWAsia
Hyphaene dichotoma	EAsiaPacific
Hyphaene guineensis	AfricaWAsia
Hyphaene macrosperma	AfricaWAsia
Hyphaene petersiana	AfricaWAsia
Hyphaene reptans	AfricaWAsia
Hyphaene thebaica	AfricaWAsia
Iguanura ambigua	EAsiaPacific
Iguanura asli	EAsiaPacific
Iguanura belumensis	EAsiaPacific
Iguanura bicornis	EAsiaPacific
Iguanura borneensis	EAsiaPacific
Iguanura cemurung	EAsiaPacific
Iguanura chaiana	EAsiaPacific
Iguanura corniculata	EAsiaPacific
Iguanura curvata	EAsiaPacific
Iguanura diffusa	EAsiaPacific
Iguanura divergens	EAsiaPacific
Iguanura elegans	EAsiaPacific
Iguanura geonomiformis	EAsiaPacific
Iguanura humilis	EAsiaPacific
Iguanura kelantanensis	EAsiaPacific
Iguanura leucocarpa	EAsiaPacific
Iguanura macrostachya	EAsiaPacific
Iguanura melinauensis	EAsiaPacific
Iguanura minor	EAsiaPacific
Iguanura mirabilis	EAsiaPacific
Iguanura myochodoides	EAsiaPacific
Iguanura palmuncula	EAsiaPacific
Iguanura parvula	EAsiaPacific
Iguanura perdana	EAsiaPacific
Iguanura piahensis	EAsiaPacific
Iguanura polymorpha	EAsiaPacific
Iguanura prolifera	EAsiaPacific
Iguanura remotiflora	EAsiaPacific
Iguanura sanderiana	EAsiaPacific
Iguanura speciosa	EAsiaPacific
Iguanura tenuis	EAsiaPacific
Iguanura thalangensis	EAsiaPacific
Iguanura wallichiana	EAsiaPacific
Iriartea deltoidea	Americas
Iriartella setigera	Americas
Iriartella stenocarpa	Americas
Itaya amicorum	Americas
Jailoloa halmaherensis	EAsiaPacific
Johannesteijsmannia altifrons	EAsiaPacific
Johannesteijsmannia lanceolata	EAsiaPacific
Johannesteijsmannia magnifica	EAsiaPacific
Johannesteijsmannia perakensis	EAsiaPacific
Juania australis	Americas
Jubaea chilensis	Americas
Jubaeopsis caffra	AfricaWAsia
Kentiopsis magnifica	EAsiaPacific
Kentiopsis oliviformis	EAsiaPacific
Kentiopsis piersoniorum	EAsiaPacific
Kentiopsis pyriformis	EAsiaPacific
Kerriodoxa elegans	EAsiaPacific
Korthalsia angustifolia	EAsiaPacific
Korthalsia bejaudii	EAsiaPacific
Korthalsia brassii	EAsiaPacific
Korthalsia celebica	EAsiaPacific
Korthalsia cheb	EAsiaPacific
Korthalsia concolor	EAsiaPacific
Korthalsia debilis	EAsiaPacific
Korthalsia echinometra	EAsiaPacific
Korthalsia ferox	EAsiaPacific
Korthalsia flagellaris	EAsiaPacific
Korthalsia furcata	EAsiaPacific
Korthalsia furtadoana	EAsiaPacific
Korthalsia hispida	EAsiaPacific
Korthalsia jala	EAsiaPacific
Korthalsia junghuhnii	EAsiaPacific
Korthalsia laciniosa	EAsiaPacific
Korthalsia lanceolata	EAsiaPacific
Korthalsia merrillii	EAsiaPacific
Korthalsia minor	EAsiaPacific
Korthalsia paucijuga	EAsiaPacific
Korthalsia rigida	EAsiaPacific
Korthalsia robusta	EAsiaPacific
Korthalsia rogersii	EAsiaPacific
Korthalsia rostrata	EAsiaPacific
Korthalsia scaphigeroides	EAsiaPacific
Korthalsia scortechinii	EAsiaPacific
Korthalsia tenuissima	EAsiaPacific
Korthalsia zippelii	EAsiaPacific
Laccospadix australasicus	EAsiaPacific
Laccosperma acutiflorum	AfricaWAsia
Laccosperma cristalensis	AfricaWAsia
Laccosperma korupense	AfricaWAsia
Laccosperma laeve	AfricaWAsia
Laccosperma opacum	AfricaWAsia
Laccosperma robustum	AfricaWAsia
Laccosperma secundiflorum	AfricaWAsia
Lanonia acaulis	EAsiaPacific
Lanonia calciphila	EAsiaPacific
Lanonia centralis	EAsiaPacific
Lanonia dasyantha	EAsiaPacific
Lanonia gracilis	EAsiaPacific
Lanonia hainanensis	EAsiaPacific
Lanonia hexasepala	EAsiaPacific
Lanonia magalonii	EAsiaPacific
Latania loddigesii	AfricaWAsia
Latania lontaroides	AfricaWAsia
Latania verschaffeltii	AfricaWAsia
Lemurophoenix halleuxii	AfricaWAsia
Leopoldinia piassaba	Americas
Leopoldinia pulchra	Americas
Lepidocaryum tenue	Americas
Lepidorrhachis mooreana	EAsiaPacific
Leucothrinax morrisii	Americas
Licuala acuminata	EAsiaPacific
Licuala acutifida	EAsiaPacific
Licuala adscendens	EAsiaPacific
Licuala ahlidurii	EAsiaPacific
Licuala angustiloba	EAsiaPacific
Licuala anomala	EAsiaPacific
Licuala aruensis	EAsiaPacific
Licuala atrovirens	EAsiaPacific
Licuala atroviridis	EAsiaPacific
Licuala averyanovii	EAsiaPacific
Licuala bachmaensis	EAsiaPacific
Licuala bacularia	EAsiaPacific
Licuala bayana	EAsiaPacific
Licuala beccariana	EAsiaPacific
Licuala bellatula	EAsiaPacific
Licuala bidentata	EAsiaPacific
Licuala bidoupensis	EAsiaPacific
Licuala bifida	EAsiaPacific
Licuala bintulensis	EAsiaPacific
Licuala bissula	EAsiaPacific
Licuala borneensis	EAsiaPacific
Licuala bracteata	EAsiaPacific
Licuala brevicalyx	EAsiaPacific
Licuala bruneiana	EAsiaPacific
Licuala burretii	EAsiaPacific
Licuala cabalionii	EAsiaPacific
Licuala cameronensis	EAsiaPacific
Licuala campestris	EAsiaPacific
Licuala cattienensis	EAsiaPacific
Licuala celebica	EAsiaPacific
Licuala chaiana	EAsiaPacific
Licuala collina	EAsiaPacific
Licuala concinna	EAsiaPacific
Licuala cordata	EAsiaPacific
Licuala corneri	EAsiaPacific
Licuala crassiflora	EAsiaPacific
Licuala dakrongensis	EAsiaPacific
Licuala debilis	EAsiaPacific
Licuala densiflora	EAsiaPacific
Licuala distans	EAsiaPacific
Licuala egregia	EAsiaPacific
Licuala elegans	EAsiaPacific
Licuala ellipsoidalis	EAsiaPacific
Licuala elliptica	EAsiaPacific
Licuala exigua	EAsiaPacific
Licuala ferruginea	EAsiaPacific
Licuala ferruginoides	EAsiaPacific
Licuala flammula	EAsiaPacific
Licuala flavida	EAsiaPacific
Licuala flexuosa	EAsiaPacific
Licuala fordiana	EAsiaPacific
Licuala fractiflexa	EAsiaPacific
Licuala gjellerupii	EAsiaPacific
Licuala glaberrima	EAsiaPacific
Licuala glabra	EAsiaPacific
Licuala graminifolia	EAsiaPacific
Licuala grandiflora	EAsiaPacific
Licuala grandis	EAsiaPacific
Licuala hallieriana	EAsiaPacific
Licuala insignis	EAsiaPacific
Licuala intermedia	EAsiaPacific
Licuala kamarudinii	EAsiaPacific
Licuala kemamanensis	EAsiaPacific
Licuala khoonmengii	EAsiaPacific
Licuala kiahii	EAsiaPacific
Licuala kingiana	EAsiaPacific
Licuala klossii	EAsiaPacific
Licuala kuchingensis	EAsiaPacific
Licuala kunstleri	EAsiaPacific
Licuala lambii	EAsiaPacific
Licuala lanata	EAsiaPacific
Licuala lanuginosa	EAsiaPacific
Licuala lauterbachii	EAsiaPacific
Licuala leopoldii	EAsiaPacific
Licuala leprosa	EAsiaPacific
Licuala leptocalyx	EAsiaPacific
Licuala leucocarpa	EAsiaPacific
Licuala linearis	EAsiaPacific
Licuala longicalycata	EAsiaPacific
Licuala longiflora	EAsiaPacific
Licuala longipes	EAsiaPacific
Licuala longispadix	EAsiaPacific
Licuala macrantha	EAsiaPacific
Licuala maculata	EAsiaPacific
Licuala magna	EAsiaPacific
Licuala malajana	EAsiaPacific
Licuala manglaensis	EAsiaPacific
Licuala mattanensis	EAsiaPacific
Licuala meijeri	EAsiaPacific
Licuala merguensis	EAsiaPacific
Licuala micholitzii	EAsiaPacific
Licuala micrantha	EAsiaPacific
Licuala mirabilis	EAsiaPacific
Licuala miriensis	EAsiaPacific
Licuala modesta	EAsiaPacific
Licuala montana	EAsiaPacific
Licuala moszkowskiana	EAsiaPacific
Licuala moyseyi	EAsiaPacific
Licuala mukahensis	EAsiaPacific
Licuala mustapana	EAsiaPacific
Licuala nana	EAsiaPacific
Licuala naumannii	EAsiaPacific
Licuala naumoniensis	EAsiaPacific
Licuala olivifera	EAsiaPacific
Licuala oliviformis	EAsiaPacific
Licuala oninensis	EAsiaPacific
Licuala orbicularis	EAsiaPacific
Licuala oryzoides	EAsiaPacific
Licuala pachycalyx	EAsiaPacific
Licuala pahangensis	EAsiaPacific
Licuala palas	EAsiaPacific
Licuala paludosa	EAsiaPacific
Licuala parviflora	EAsiaPacific
Licuala patens	EAsiaPacific
Licuala paucisecta	EAsiaPacific
Licuala peekelii	EAsiaPacific
Licuala peltata	EAsiaPacific
Licuala penduliflora	EAsiaPacific
Licuala petiolulata	EAsiaPacific
Licuala pilosa	EAsiaPacific
Licuala pitta	EAsiaPacific
Licuala platydactyla	EAsiaPacific
Licuala polyschista	EAsiaPacific
Licuala poonsakii	EAsiaPacific
Licuala pseudovalida	EAsiaPacific
Licuala pulchella	EAsiaPacific
Licuala pumila	EAsiaPacific
Licuala punctulata	EAsiaPacific
Licuala pusilla	EAsiaPacific
Licuala radula	EAsiaPacific
Licuala ramsayi	EAsiaPacific
Licuala reptans	EAsiaPacific
Licuala rheophytica	EAsiaPacific
Licuala ridleyana	EAsiaPacific
Licuala robinsoniana	EAsiaPacific
Licuala robusta	EAsiaPacific
Licuala rubiginosa	EAsiaPacific
Licuala rumphii	EAsiaPacific
Licuala ruthiae	EAsiaPacific
Licuala sabahana	EAsiaPacific
Licuala sallehana	EAsiaPacific
Licuala sarawakensis	EAsiaPacific
Licuala scortechinii	EAsiaPacific
Licuala simplex	EAsiaPacific
Licuala spathellifera	EAsiaPacific
Licuala spectabilis	EAsiaPacific
Licuala spicata	EAsiaPacific
Licuala spinosa	EAsiaPacific
Licuala steinii	EAsiaPacific
Licuala stipitata	EAsiaPacific
Licuala stongensis	EAsiaPacific
Licuala tanycola	EAsiaPacific
Licuala taynguyensis	EAsiaPacific
Licuala telifera	EAsiaPacific
Licuala tenuissima	EAsiaPacific
Licuala terengganuensis	EAsiaPacific
Licuala thoana	EAsiaPacific
Licuala tiomanensis	EAsiaPacific
Licuala triphylla	EAsiaPacific
Licuala urciflora	EAsiaPacific
Licuala whitmorei	EAsiaPacific
Licuala yiiana	EAsiaPacific
Linospadix albertisianus	EAsiaPacific
Linospadix apetiolatus	EAsiaPacific
Linospadix caninus	EAsiaPacific
Linospadix microcaryus	EAsiaPacific
Linospadix minor	EAsiaPacific
Linospadix monostachyos	EAsiaPacific
Linospadix palmerianus	EAsiaPacific
Livistona alfredii	EAsiaPacific
Livistona australis	EAsiaPacific
Livistona benthamii	EAsiaPacific
Livistona boninensis	EAsiaPacific
Livistona carinensis	AfricaWAsia
Livistona chinensis	EAsiaPacific
Livistona concinna	EAsiaPacific
Livistona decora	EAsiaPacific
Livistona drudei	EAsiaPacific
Livistona eastonii	EAsiaPacific
Livistona endauensis	EAsiaPacific
Livistona exigua	EAsiaPacific
Livistona fulva	EAsiaPacific
Livistona halongensis	EAsiaPacific
Livistona humilis	EAsiaPacific
Livistona inermis	EAsiaPacific
Livistona jenkinsiana	EAsiaPacific
Livistona lanuginosa	EAsiaPacific
Livistona lorophylla	EAsiaPacific
Livistona mariae	EAsiaPacific
Livistona muelleri	EAsiaPacific
Livistona nasmophila	EAsiaPacific
Livistona nitida	EAsiaPacific
Livistona rigida	EAsiaPacific
Livistona saribus	EAsiaPacific
Livistona speciosa	EAsiaPacific
Livistona tahanensis	EAsiaPacific
Livistona victoriae	EAsiaPacific
Lodoicea maldivica	AfricaWAsia
Loxococcus rupicola	EAsiaPacific
Manicaria martiana	Americas
Manicaria saccifera	Americas
Manjekia maturbongsii	EAsiaPacific
Marojejya darianii	AfricaWAsia
Marojejya insignis	AfricaWAsia
Masoala kona	AfricaWAsia
Masoala madagascariensis	AfricaWAsia
Mauritia carana	Americas
Mauritia flexuosa	Americas
Mauritiella aculeata	Americas
Mauritiella armata	Americas
Mauritiella macroclada	Americas
Mauritiella pumila	Americas
Maxburretia furtadoana	EAsiaPacific
Maxburretia gracilis	EAsiaPacific
Maxburretia rupicola	EAsiaPacific
Medemia argun	AfricaWAsia
Metroxylon amicarum	EAsiaPacific
Metroxylon paulcoxii	Americas
Metroxylon sagu	EAsiaPacific
Metroxylon salomonense	EAsiaPacific
Metroxylon upoluense	Americas
Metroxylon vitiense	EAsiaPacific
Metroxylon warburgii	Americas
Myrialepis paradoxa	EAsiaPacific
Nannorrhops baluchestanica	AfricaWAsia
Nannorrhops ritchieana	AfricaWAsia
Nenga banaensis	EAsiaPacific
Nenga gajah	EAsiaPacific
Nenga grandiflora	EAsiaPacific
Nenga macrocarpa	EAsiaPacific
Nenga pumila	EAsiaPacific
Neonicholsonia watsonii	Americas
Neoveitchia brunnea	EAsiaPacific
Neoveitchia storckii	EAsiaPacific
Nephrosperma vanhoutteanum	AfricaWAsia
Normanbya normanbyi	EAsiaPacific
Nypa fruticans	EAsiaPacific
Oenocarpus bacaba	Americas
Oenocarpus balickii	Americas
Oenocarpus bataua	Americas
Oenocarpus circumtextus	Americas
Oenocarpus distichus	Americas
Oenocarpus makeru	Americas
Oenocarpus mapora	Americas
Oenocarpus minor	Americas
Oenocarpus simplex	Americas
Oncocalamus macrospathus	AfricaWAsia
Oncocalamus mannii	AfricaWAsia
Oncocalamus tuleyi	AfricaWAsia
Oncocalamus wrightianus	AfricaWAsia
Oncosperma fasciculatum	EAsiaPacific
Oncosperma gracilipes	EAsiaPacific
Oncosperma horridum	EAsiaPacific
Oncosperma platyphyllum	EAsiaPacific
Oncosperma tigillarium	EAsiaPacific
Orania archboldiana	EAsiaPacific
Orania bakeri	EAsiaPacific
Orania dafonsoroensis	EAsiaPacific
Orania decipiens	EAsiaPacific
Orania deflexa	EAsiaPacific
Orania disticha	EAsiaPacific
Orania ferruginea	EAsiaPacific
Orania gagavu	EAsiaPacific
Orania glauca	EAsiaPacific
Orania grandiflora	EAsiaPacific
Orania lauterbachiana	EAsiaPacific
Orania littoralis	EAsiaPacific
Orania longisquama	AfricaWAsia
Orania longistaminodia	EAsiaPacific
Orania macropetala	EAsiaPacific
Orania micrantha	EAsiaPacific
Orania oreophila	EAsiaPacific
Orania palindan	EAsiaPacific
Orania paraguanensis	EAsiaPacific
Orania parva	EAsiaPacific
Orania ravaka	AfricaWAsia
Orania regalis	EAsiaPacific
Orania subdisticha	EAsiaPacific
Orania sylvicola	EAsiaPacific
Orania tabubilensis	EAsiaPacific
Orania timikae	EAsiaPacific
Orania trispatha	AfricaWAsia
Orania zonae	EAsiaPacific
Oraniopsis appendiculata	EAsiaPacific
Parajubaea cocoides	Americas
Parajubaea sunkha	Americas
Parajubaea torallyi	Americas
Pelagodoxa henryana	EAsiaPacific
Phoenicophorium borsigianum	AfricaWAsia
Phoenix acaulis	EAsiaPacific
Phoenix atlantica	AfricaWAsia
Phoenix caespitosa	AfricaWAsia
Phoenix canariensis	AfricaWAsia
Phoenix dactylifera	AfricaWAsia
Phoenix loureiroi	EAsiaPacific
Phoenix paludosa	EAsiaPacific
Phoenix pusilla	EAsiaPacific
Phoenix reclinata	AfricaWAsia
Phoenix roebelenii	EAsiaPacific
Phoenix rupicola	EAsiaPacific
Phoenix sylvestris	EAsiaPacific
Phoenix theophrasti	AfricaWAsia
Pholidocarpus ihur	EAsiaPacific
Pholidocarpus kingianus	EAsiaPacific
Pholidocarpus macrocarpus	EAsiaPacific
Pholidocarpus majadum	EAsiaPacific
Pholidocarpus mucronatus	EAsiaPacific
Pholidocarpus sumatranus	EAsiaPacific
Pholidostachys amazonensis	Americas
Pholidostachys dactyloides	Americas
Pholidostachys kalbreyeri	Americas
Pholidostachys occidentalis	Americas
Pholidostachys panamensis	Americas
Pholidostachys pulchra	Americas
Pholidostachys sanluisensis	Americas
Pholidostachys synanthera	Americas
Physokentia avia	EAsiaPacific
Physokentia dennisii	EAsiaPacific
Physokentia insolita	EAsiaPacific
Physokentia petiolata	EAsiaPacific
Physokentia tete	EAsiaPacific
Physokentia thurstonii	EAsiaPacific
Physokentia whitmorei	EAsiaPacific
Phytelephas aequatorialis	Americas
Phytelephas macrocarpa	Americas
Phytelephas tenuicaulis	Americas
Phytelephas tumacana	Americas
Pigafetta elata	EAsiaPacific
Pigafetta filaris	EAsiaPacific
Pinanga acaulis	EAsiaPacific
Pinanga acuminata	EAsiaPacific
Pinanga adangensis	EAsiaPacific
Pinanga albescens	EAsiaPacific
Pinanga andamanensis	EAsiaPacific
Pinanga angustisecta	EAsiaPacific
Pinanga annamensis	EAsiaPacific
Pinanga arinasae	EAsiaPacific
Pinanga aristata	EAsiaPacific
Pinanga arundinacea	EAsiaPacific
Pinanga auriculata	EAsiaPacific
Pinanga badia	EAsiaPacific
Pinanga basilanensis	EAsiaPacific
Pinanga batanensis	EAsiaPacific
Pinanga baviensis	EAsiaPacific
Pinanga bicolana	EAsiaPacific
Pinanga borneensis	EAsiaPacific
Pinanga brevipes	EAsiaPacific
Pinanga brewsteriana	EAsiaPacific
Pinanga caesia	EAsiaPacific
Pinanga capitata	EAsiaPacific
Pinanga cattienensis	EAsiaPacific
Pinanga celebica	EAsiaPacific
Pinanga chaiana	EAsiaPacific
Pinanga cleistantha	EAsiaPacific
Pinanga copelandii	EAsiaPacific
Pinanga coronata	EAsiaPacific
Pinanga crassipes	EAsiaPacific
Pinanga cucullata	EAsiaPacific
Pinanga cupularis	EAsiaPacific
Pinanga curranii	EAsiaPacific
Pinanga declinata	EAsiaPacific
Pinanga decora	EAsiaPacific
Pinanga densiflora	EAsiaPacific
Pinanga dicksonii	EAsiaPacific
Pinanga disticha	EAsiaPacific
Pinanga dumetosa	EAsiaPacific
Pinanga egregia	EAsiaPacific
Pinanga forbesii	EAsiaPacific
Pinanga fractiflexa	EAsiaPacific
Pinanga furfuracea	EAsiaPacific
Pinanga geonomiformis	EAsiaPacific
Pinanga glauca	EAsiaPacific
Pinanga glaucescens	EAsiaPacific
Pinanga glaucifolia	EAsiaPacific
Pinanga globulifera	EAsiaPacific
Pinanga gracilis	EAsiaPacific
Pinanga gracillima	EAsiaPacific
Pinanga grandijuga	EAsiaPacific
Pinanga grandis	EAsiaPacific
Pinanga griffithii	EAsiaPacific
Pinanga heterophylla	EAsiaPacific
Pinanga hexasticha	EAsiaPacific
Pinanga hookeriana	EAsiaPacific
Pinanga humilis	EAsiaPacific
Pinanga hymenospatha	EAsiaPacific
Pinanga inaequalis	EAsiaPacific
Pinanga insignis	EAsiaPacific
Pinanga isabelensis	EAsiaPacific
Pinanga jamariensis	EAsiaPacific
Pinanga jambusana	EAsiaPacific
Pinanga javana	EAsiaPacific
Pinanga johorensis	EAsiaPacific
Pinanga keahii	EAsiaPacific
Pinanga kontumensis	EAsiaPacific
Pinanga lacei	EAsiaPacific
Pinanga latisecta	EAsiaPacific
Pinanga lepidota	EAsiaPacific
Pinanga ligulata	EAsiaPacific
Pinanga limbangensis	EAsiaPacific
Pinanga limosa	EAsiaPacific
Pinanga macrospadix	EAsiaPacific
Pinanga maculata	EAsiaPacific
Pinanga malaiana	EAsiaPacific
Pinanga manii	EAsiaPacific
Pinanga megalocarpa	EAsiaPacific
Pinanga micholitzii	EAsiaPacific
Pinanga minor	EAsiaPacific
Pinanga minuta	EAsiaPacific
Pinanga mirabilis	EAsiaPacific
Pinanga modesta	EAsiaPacific
Pinanga mooreana	EAsiaPacific
Pinanga negrosensis	EAsiaPacific
Pinanga nuichuensis	EAsiaPacific
Pinanga pachycarpa	EAsiaPacific
Pinanga pachyphylla	EAsiaPacific
Pinanga palustris	EAsiaPacific
Pinanga pantiensis	EAsiaPacific
Pinanga paradoxa	EAsiaPacific
Pinanga parvula	EAsiaPacific
Pinanga patula	EAsiaPacific
Pinanga pectinata	EAsiaPacific
Pinanga perakensis	EAsiaPacific
Pinanga philippinensis	EAsiaPacific
Pinanga pilosa	EAsiaPacific
Pinanga plicata	EAsiaPacific
Pinanga polymorpha	EAsiaPacific
Pinanga porrecta	EAsiaPacific
Pinanga pulchella	EAsiaPacific
Pinanga purpurea	EAsiaPacific
Pinanga quadrijuga	EAsiaPacific
Pinanga ridleyana	EAsiaPacific
Pinanga rigida	EAsiaPacific
Pinanga riparia	EAsiaPacific
Pinanga rivularis	EAsiaPacific
Pinanga rumphiana	EAsiaPacific
Pinanga rupestris	EAsiaPacific
Pinanga salicifolia	EAsiaPacific
Pinanga samarana	EAsiaPacific
Pinanga sarmentosa	EAsiaPacific
Pinanga sclerophylla	EAsiaPacific
Pinanga scortechinii	EAsiaPacific
Pinanga sembilan	EAsiaPacific
Pinanga sessilifolia	EAsiaPacific
Pinanga sibuyanensis	EAsiaPacific
Pinanga sierramadreana	EAsiaPacific
Pinanga simplicifrons	EAsiaPacific
Pinanga singaporensis	EAsiaPacific
Pinanga sobolifera	EAsiaPacific
Pinanga speciosa	EAsiaPacific
Pinanga stricta	EAsiaPacific
Pinanga stylosa	EAsiaPacific
Pinanga subintegra	EAsiaPacific
Pinanga subruminata	EAsiaPacific
Pinanga sylvestris	EAsiaPacific
Pinanga tashiroi	EAsiaPacific
Pinanga tenacinervis	EAsiaPacific
Pinanga tenella	EAsiaPacific
Pinanga tomentella	EAsiaPacific
Pinanga tomentosa	EAsiaPacific
Pinanga trichoneura	EAsiaPacific
Pinanga uncinata	EAsiaPacific
Pinanga urdanetensis	EAsiaPacific
Pinanga urosperma	EAsiaPacific
Pinanga variegata	EAsiaPacific
Pinanga veitchii	EAsiaPacific
Pinanga versicolor	EAsiaPacific
Pinanga watanaiana	EAsiaPacific
Pinanga woodiana	EAsiaPacific
Pinanga yassinii	EAsiaPacific
Plectocomia assamica	EAsiaPacific
Plectocomia billitonensis	EAsiaPacific
Plectocomia bractealis	EAsiaPacific
Plectocomia dransfieldiana	EAsiaPacific
Plectocomia elmeri	EAsiaPacific
Plectocomia elongata	EAsiaPacific
Plectocomia himalayana	EAsiaPacific
Plectocomia khasyana	EAsiaPacific
Plectocomia longistigma	EAsiaPacific
Plectocomia lorzingii	EAsiaPacific
Plectocomia macrostachya	EAsiaPacific
Plectocomia microstachys	EAsiaPacific
Plectocomia mulleri	EAsiaPacific
Plectocomia pierreana	EAsiaPacific
Plectocomia pygmaea	EAsiaPacific
Plectocomiopsis corneri	EAsiaPacific
Plectocomiopsis geminiflora	EAsiaPacific
Plectocomiopsis mira	EAsiaPacific
Plectocomiopsis songthanhensis	EAsiaPacific
Plectocomiopsis triquetra	EAsiaPacific
Plectocomiopsis wrayi	EAsiaPacific
Podococcus acaulis	AfricaWAsia
Podococcus barteri	AfricaWAsia
Ponapea hentyi	EAsiaPacific
Ponapea hosinoi	EAsiaPacific
Ponapea ledermanniana	EAsiaPacific
Ponapea palauensis	EAsiaPacific
Prestoea acuminata	Americas
Prestoea carderi	Americas
Prestoea decurrens	Americas
Prestoea ensiformis	Americas
Prestoea longepetiolata	Americas
Prestoea pubens	Americas
Prestoea pubigera	Americas
Prestoea schultzeana	Americas
Prestoea simplicifolia	Americas
Prestoea tenuiramosa	Americas
Pritchardia arecina	Americas
Pritchardia bakeri	Americas
Pritchardia beccariana	Americas
Pritchardia flynnii	Americas
Pritchardia forbesiana	Americas
Pritchardia glabrata	Americas
Pritchardia gordonii	Americas
Pritchardia hardyi	Americas
Pritchardia hillebrandii	Americas
Pritchardia kaalae	Americas
Pritchardia kahukuensis	Americas
Pritchardia lanigera	Americas
Pritchardia lowreyana	Americas
Pritchardia maideniana	Americas
Pritchardia martii	Americas
Pritchardia minor	Americas
Pritchardia mitiaroana	Americas
Pritchardia munroi	Americas
Pritchardia napaliensis	Americas
Pritchardia pacifica	EAsiaPacific
Pritchardia perlmanii	Americas
Pritchardia remota	Americas
Pritchardia schattaueri	Americas
Pritchardia thurstonii	EAsiaPacific
Pritchardia viscosa	Americas
Pritchardia vuylstekeana	Americas
Pritchardia waialealeana	Americas
Pritchardia woodii	Americas
Pseudophoenix ekmanii	Americas
Pseudophoenix lediniana	Americas
Pseudophoenix sargentii	Americas
Pseudophoenix vinifera	Americas
Ptychococcus lepidotus	EAsiaPacific
Ptychococcus paradoxus	EAsiaPacific
Ptychosperma ambiguum	EAsiaPacific
Ptychosperma buabe	EAsiaPacific
Ptychosperma burretianum	EAsiaPacific
Ptychosperma caryotoides	EAsiaPacific
Ptychosperma cuneatum	EAsiaPacific
Ptychosperma elegans	Americas
Ptychosperma furcatum	EAsiaPacific
Ptychosperma gracile	EAsiaPacific
Ptychosperma hartmannii	EAsiaPacific
Ptychosperma lauterbachii	EAsiaPacific
Ptychosperma lineare	EAsiaPacific
Ptychosperma macarthurii	EAsiaPacific
Ptychosperma macrocerum	EAsiaPacific
Ptychosperma mambare	EAsiaPacific
Ptychosperma microcarpum	EAsiaPacific
Ptychosperma mooreanum	EAsiaPacific
Ptychosperma nicolai	EAsiaPacific
Ptychosperma praemorsum	EAsiaPacific
Ptychosperma propinquum	EAsiaPacific
Ptychosperma pullenii	EAsiaPacific
Ptychosperma ramosissimum	EAsiaPacific
Ptychosperma rosselense	EAsiaPacific
Ptychosperma salomonense	EAsiaPacific
Ptychosperma sanderianum	EAsiaPacific
Ptychosperma schefferi	EAsiaPacific
Ptychosperma streimannii	EAsiaPacific
Ptychosperma tagulense	EAsiaPacific
Ptychosperma vestitum	EAsiaPacific
Ptychosperma waitianum	EAsiaPacific
Raphia africana	AfricaWAsia
Raphia australis	AfricaWAsia
Raphia farinifera	AfricaWAsia
Raphia gentiliana	AfricaWAsia
Raphia hookeri	AfricaWAsia
Raphia laurentii	AfricaWAsia
Raphia longiflora	AfricaWAsia
Raphia mambillensis	AfricaWAsia
Raphia mannii	AfricaWAsia
Raphia matombe	AfricaWAsia
Raphia monbuttorum	AfricaWAsia
Raphia palma-pinus	AfricaWAsia
Raphia regalis	AfricaWAsia
Raphia rostrata	AfricaWAsia
Raphia ruwenzorica	AfricaWAsia
Raphia sese	AfricaWAsia
Raphia sudanica	AfricaWAsia
Raphia taedigera	Americas
Raphia textilis	AfricaWAsia
Raphia vinifera	AfricaWAsia
Ravenea albicans	AfricaWAsia
Ravenea beentjei	AfricaWAsia
Ravenea declivium	AfricaWAsia
Ravenea delicatula	AfricaWAsia
Ravenea dransfieldii	AfricaWAsia
Ravenea glauca	AfricaWAsia
Ravenea hildebrandtii	AfricaWAsia
Ravenea hypoleuca	AfricaWAsia
Ravenea julietiae	AfricaWAsia
Ravenea krociana	AfricaWAsia
Ravenea lakatra	AfricaWAsia
Ravenea latisecta	AfricaWAsia
Ravenea louvelii	AfricaWAsia
Ravenea madagascariensis	AfricaWAsia
Ravenea moorei	AfricaWAsia
Ravenea musicalis	AfricaWAsia
Ravenea nana	AfricaWAsia
Ravenea rivularis	AfricaWAsia
Ravenea robustior	AfricaWAsia
Ravenea sambiranensis	AfricaWAsia
Ravenea xerophila	AfricaWAsia
Reinhardtia elegans	Americas
Reinhardtia gracilis	Americas
Reinhardtia koschnyana	Americas
Reinhardtia latisecta	Americas
Reinhardtia paiewonskiana	Americas
Reinhardtia simplex	Americas
Rhapidophyllum hystrix	Americas
Rhapis evansii	EAsiaPacific
Rhapis excelsa	EAsiaPacific
Rhapis gracilis	EAsiaPacific
Rhapis humilis	EAsiaPacific
Rhapis kebangensis	EAsiaPacific
Rhapis laosensis	EAsiaPacific
Rhapis micrantha	EAsiaPacific
Rhapis puhuongensis	EAsiaPacific
Rhapis robusta	EAsiaPacific
Rhapis subtilis	EAsiaPacific
Rhapis vidalii	EAsiaPacific
Rhopaloblaste augusta	EAsiaPacific
Rhopaloblaste ceramica	EAsiaPacific
Rhopaloblaste elegans	EAsiaPacific
Rhopaloblaste gideonii	EAsiaPacific
Rhopaloblaste ledermanniana	EAsiaPacific
Rhopaloblaste singaporensis	EAsiaPacific
Rhopalostylis baueri	EAsiaPacific
Rhopalostylis sapida	EAsiaPacific
Roscheria melanochaetes	AfricaWAsia
Roystonea altissima	Americas
Roystonea borinquena	Americas
Roystonea dunlapiana	Americas
Roystonea lenis	Americas
Roystonea maisiana	Americas
Roystonea oleracea	Americas
Roystonea princeps	Americas
Roystonea regia	Americas
Roystonea stellata	Americas
Roystonea violacea	Americas
Sabal bermudana	Americas
Sabal causiarum	Americas
Sabal domingensis	Americas
Sabal etonia	Americas
Sabal gretherae	Americas
Sabal maritima	Americas
Sabal mauritiiformis	Americas
Sabal mexicana	Americas
Sabal minor	Americas
Sabal palmetto	Americas
Sabal pumos	Americas
Sabal rosei	Americas
Sabal uresana	Americas
Sabal yapa	Americas
Sabinaria magnifica	Americas
Salacca acehensis	EAsiaPacific
Salacca affinis	EAsiaPacific
Salacca bakeriana	EAsiaPacific
Salacca clemensiana	EAsiaPacific
Salacca dolicholepis	EAsiaPacific
Salacca dransfieldiana	EAsiaPacific
Salacca flabellata	EAsiaPacific
Salacca glabrescens	EAsiaPacific
Salacca graciliflora	EAsiaPacific
Salacca griffithii	EAsiaPacific
Salacca lophospatha	EAsiaPacific
Salacca magnifica	EAsiaPacific
Salacca minuta	EAsiaPacific
Salacca multiflora	EAsiaPacific
Salacca ramosiana	EAsiaPacific
Salacca rupicola	EAsiaPacific
Salacca sarawakensis	EAsiaPacific
Salacca secunda	EAsiaPacific
Salacca stolonifera	EAsiaPacific
Salacca sumatrana	EAsiaPacific
Salacca vermicularis	EAsiaPacific
Salacca wallichiana	EAsiaPacific
Salacca zalacca	EAsiaPacific
Saribus brevifolius	EAsiaPacific
Saribus chocolatinus	EAsiaPacific
Saribus jeanneneyi	EAsiaPacific
Saribus merrillii	EAsiaPacific
Saribus papuanus	EAsiaPacific
Saribus rotundifolius	EAsiaPacific
Saribus surru	EAsiaPacific
Saribus tothur	EAsiaPacific
Saribus woodfordii	EAsiaPacific
Satakentia liukiuensis	EAsiaPacific
Satranala decussilvae	AfricaWAsia
Schippia concolor	Americas
Sclerosperma mannii	AfricaWAsia
Sclerosperma profizianum	AfricaWAsia
Sclerosperma walkeri	AfricaWAsia
Serenoa repens	Americas
Socratea exorrhiza	Americas
Socratea hecatonandra	Americas
Socratea karstenii	Americas
Socratea rostrata	Americas
Socratea salazarii	Americas
Sommieria leucophylla	EAsiaPacific
Syagrus allagopteroides	Americas
Syagrus amara	Americas
Syagrus angustifolia	Americas
Syagrus botryophora	Americas
Syagrus caerulescens	Americas
Syagrus campestris	Americas
Syagrus campylospatha	Americas
Syagrus cardenasii	Americas
Syagrus cearensis	Americas
Syagrus cerqueirana	Americas
Syagrus cocoides	Americas
Syagrus comosa	Americas
Syagrus coronata	Americas
Syagrus deflexa	Americas
Syagrus duartei	Americas
Syagrus emasensis	Americas
Syagrus evansiana	Americas
Syagrus flexuosa	Americas
Syagrus glaucescens	Americas
Syagrus glazioviana	Americas
Syagrus gouveiana	Americas
Syagrus graminifolia	Americas
Syagrus guimaraesensis	Americas
Syagrus harleyi	Americas
Syagrus hoehnei	Americas
Syagrus inajai	Americas
Syagrus insignis	Americas
Syagrus itacambirana	Americas
Syagrus itapebiensis	Americas
Syagrus kellyana	Americas
Syagrus lilliputiana	Americas
Syagrus loefgrenii	Americas
Syagrus longipedunculata	Americas
Syagrus lorenzoniorum	Americas
Syagrus macrocarpa	Americas
Syagrus mendanhensis	Americas
Syagrus menzeliana	Americas
Syagrus microphylla	Americas
Syagrus minor	Americas
Syagrus oleracea	Americas
Syagrus orinocensis	Americas
Syagrus petraea	Americas
Syagrus picrophylla	Americas
Syagrus pleioclada	Americas
Syagrus pleiocladoides	Americas
Syagrus pompeoi	Americas
Syagrus procumbens	Americas
Syagrus pseudococos	Americas
Syagrus romanzoffiana	Americas
Syagrus rupicola	Americas
Syagrus ruschiana	Americas
Syagrus sancona	Americas
Syagrus santosii	Americas
Syagrus schizophylla	Americas
Syagrus smithii	Americas
Syagrus stenopetala	Americas
Syagrus stratincola	Americas
Syagrus vagans	Americas
Syagrus vermicularis	Americas
Syagrus weddelliana	Americas
Syagrus werdermannii	Americas
Syagrus yungasensis	Americas
Synechanthus dasystachys	Americas
Synechanthus fibrosus	Americas
Synechanthus warscewiczianus	Americas
Tahina spectabilis	AfricaWAsia
Tectiphiala ferox	AfricaWAsia
Thrinax excelsa	Americas
Thrinax parviflora	Americas
Thrinax radiata	Americas
Trachycarpus fortunei	EAsiaPacific
Trachycarpus geminisectus	EAsiaPacific
Trachycarpus latisectus	EAsiaPacific
Trachycarpus martianus	EAsiaPacific
Trachycarpus nanus	EAsiaPacific
Trachycarpus oreophilus	EAsiaPacific
Trachycarpus princeps	EAsiaPacific
Trachycarpus ravenii	EAsiaPacific
Trachycarpus takil	EAsiaPacific
Trachycarpus ukhrulensis	EAsiaPacific
Trithrinax brasiliensis	Americas
Trithrinax campestris	Americas
Trithrinax schizophylla	Americas
Veitchia arecina	EAsiaPacific
Veitchia filifera	EAsiaPacific
Veitchia joannis	EAsiaPacific
Veitchia lepidota	EAsiaPacific
Veitchia metiti	EAsiaPacific
Veitchia pachyclada	EAsiaPacific
Veitchia simulans	EAsiaPacific
Veitchia spiralis	EAsiaPacific
Veitchia subdisticha	EAsiaPacific
Veitchia vitiensis	EAsiaPacific
Veitchia winin	EAsiaPacific
Verschaffeltia splendida	AfricaWAsia
Voanioala gerardii	AfricaWAsia
Wallaceodoxa raja-ampat	EAsiaPacific
Wallichia caryotoides	EAsiaPacific
Wallichia disticha	EAsiaPacific
Wallichia gracilis	EAsiaPacific
Wallichia lidiae	EAsiaPacific
Wallichia marianneae	EAsiaPacific
Wallichia nana	EAsiaPacific
Wallichia oblongifolia	EAsiaPacific
Wallichia triandra	EAsiaPacific
Washingtonia filifera	Americas
Washingtonia robusta	Americas
Welfia alfredii	Americas
Welfia regia	Americas
Wendlandiella gracilis	Americas
Wettinia aequalis	Americas
Wettinia aequatorialis	Americas
Wettinia anomala	Americas
Wettinia augusta	Americas
Wettinia castanea	Americas
Wettinia disticha	Americas
Wettinia drudei	Americas
Wettinia fascicularis	Americas
Wettinia hirsuta	Americas
Wettinia kalbreyeri	Americas
Wettinia lanata	Americas
Wettinia longipetala	Americas
Wettinia maynensis	Americas
Wettinia microcarpa	Americas
Wettinia minima	Americas
Wettinia oxycarpa	Americas
Wettinia panamensis	Americas
Wettinia praemorsa	Americas
Wettinia quinaria	Americas
Wettinia radiata	Americas
Wettinia verruculosa	Americas
Wodyetia bifurcata	EAsiaPacific
Zombia antillarum	Americas
