"Region"	"Species"
"ABT"	"NA"
"AFG"	"Nannorrhops ritchieana, Phoenix dactylifera"
"AGE"	"Acrocomia totai, Allagoptera campestris, Allagoptera leucocalyx, Butia eriospatha, Butia noblickii, Butia poni, Butia yatay, Copernicia alba, Euterpe edulis, Syagrus romanzoffiana, Trithrinax campestris, Trithrinax schizophylla"
"AGS"	"NA"
"AGW"	"Acrocomia totai, Trithrinax campestris, Trithrinax schizophylla"
"ALA"	"Rhapidophyllum hystrix, Sabal minor, Sabal palmetto, Serenoa repens"
"ALB"	"NA"
"ALD"	"NA"
"ALG"	"Chamaerops humilis, Phoenix canariensis, Phoenix dactylifera, Washingtonia robusta"
"ALT"	"NA"
"ALU"	"NA"
"AMU"	"NA"
"AND"	"Areca catechu, Areca triandra, Arenga pinnata, Calamus andamanicus, Calamus baratangensis, Calamus kurzianus, Calamus latifolius, Calamus longisetus, Calamus luteus, Calamus manii, Calamus rarispinosus, Calamus viminalis, Calamus wrightmyoensis, Caryota mitis, Caryota urens, Cocos nucifera, Corypha umbraculifera, Corypha utan, Dypsis lutescens, Elaeis guineensis, Korthalsia laciniosa, Korthalsia rogersii, Licuala paludosa, Licuala peltata, Licuala spinosa, Livistona chinensis, Nypa fruticans, Phoenix paludosa, Phoenix rupicola, Phoenix sylvestris, Pinanga andamanensis, Pinanga manii"
"ANG"	"Calamus deerratus, Cocos nucifera, Elaeis guineensis, Eremospatha cuspidata, Hyphaene guineensis, Hyphaene petersiana, Phoenix reclinata, Raphia farinifera, Raphia hookeri, Raphia laurentii, Raphia regalis, Raphia textilis, Sclerosperma mannii, Sclerosperma profizianum"
"ANT"	"NA"
"ARI"	"Washingtonia filifera"
"ARK"	"Sabal minor"
"ARU"	"NA"
"ASC"	"Cocos nucifera"
"ASK"	"NA"
"ASP"	"NA"
"ASS"	"Areca triandra, Arenga pinnata, Arenga westerhoutii, Calamus acanthospathus, Calamus erectus, Calamus flagellum, Calamus floribundus, Calamus gracilis, Calamus guruba, Calamus inermis, Calamus jenkinsianus, Calamus kingianus, Calamus latifolius, Calamus leptospadix, Calamus longisetus, Calamus meghalayensis, Calamus tenuis, Calamus viminalis, Caryota maxima, Caryota obtusa, Caryota urens, Corypha utan, Licuala peltata, Livistona jenkinsiana, Myrialepis paradoxa, Phoenix acaulis, Phoenix loureiroi, Phoenix paludosa, Phoenix rupicola, Phoenix sylvestris, Pinanga gracilis, Pinanga griffithii, Pinanga hookeriana, Pinanga sylvestris, Plectocomia assamica, Plectocomia bractealis, Plectocomia himalayana, Plectocomia khasyana, Salacca secunda, Trachycarpus martianus, Trachycarpus ukhrulensis, Wallichia disticha, Wallichia nana, Wallichia oblongifolia"
"ATP"	"NA"
"AUT"	"NA"
"AZO"	"NA"
"BAH"	"Acoelorrhaphe wrightii, Coccothrinax argentata, Coccothrinax inaguensis, Cocos nucifera, Leucothrinax morrisii, Pseudophoenix sargentii, Roystonea regia, Sabal palmetto, Thrinax radiata"
"BAL"	"Chamaerops humilis"
"BAN"	"Areca catechu, Areca triandra, Arenga pinnata, Borassus flabellifer, Calamus arborescens, Calamus erectus, Calamus flagellum, Calamus floribundus, Calamus gracilis, Calamus guruba, Calamus inermis, Calamus jenkinsianus, Calamus latifolius, Calamus leptospadix, Calamus longisetus, Calamus tenuis, Calamus viminalis, Caryota maxima, Caryota mitis, Caryota urens, Cocos nucifera, Corypha taliera, Corypha umbraculifera, Elaeis guineensis, Licuala peltata, Licuala spinosa, Livistona jenkinsiana, Livistona speciosa, Nypa fruticans, Phoenix acaulis, Phoenix dactylifera, Phoenix loureiroi, Phoenix paludosa, Phoenix rupicola, Phoenix sylvestris, Pinanga gracilis, Pinanga hexasticha, Plectocomia himalayana, Trachycarpus martianus, Wallichia caryotoides, Wallichia disticha, Wallichia nana, Wallichia oblongifolia"
"BEN"	"Arenga pinnata, Borassus aethiopum, Borassus akeassii, Calamus deerratus, Cocos nucifera, Elaeis guineensis, Eremospatha macrocarpa, Hyphaene macrosperma, Hyphaene thebaica, Laccosperma opacum, Laccosperma secundiflorum, Oncocalamus wrightianus, Phoenix dactylifera, Phoenix reclinata, Raphia farinifera, Raphia hookeri, Raphia sudanica, Raphia vinifera"
"BER"	"Livistona chinensis, Phoenix canariensis, Phoenix reclinata, Sabal bermudana"
"BGM"	"NA"
"BIS"	"Areca catechu, Areca macrocalyx, Areca novohibernica, Calamus aruensis, Calamus longipinna, Calamus pachypus, Calamus vitiensis, Calyptrocalyx albertisianus, Caryota rumphiana, Clinostigma collegarum, Cocos nucifera, Cyrtostachys loriae, Elaeis guineensis, Heterospathe parviflora, Hydriastele costata, Hydriastele kasesa, Hydriastele manusii, Licuala peekelii, Metroxylon salomonense, Nypa fruticans, Physokentia avia, Ponapea hentyi, Ptychococcus paradoxus, Ptychosperma gracile, Rhopaloblaste gideonii"
"BKN"	"Borassus aethiopum, Borassus akeassii, Calamus deerratus, Elaeis guineensis, Hyphaene thebaica, Phoenix reclinata, Raphia farinifera, Raphia sudanica"
"BLR"	"NA"
"BLT"	"NA"
"BLZ"	"Acoelorrhaphe wrightii, Acrocomia aculeata, Asterogyne martiana, Astrocaryum mexicanum, Attalea cohune, Bactris major, Bactris mexicana, Brahea dulcis, Calyptrogyne ghiesbreghtiana, Chamaedorea adscendens, Chamaedorea arenbergiana, Chamaedorea elegans, Chamaedorea ernesti-augusti, Chamaedorea geonomiformis, Chamaedorea neurochlamys, Chamaedorea oblongata, Chamaedorea pinnatifrons, Chamaedorea schippii, Chamaedorea seifrizii, Chamaedorea tepejilote, Chamaedorea woodsoniana, Coccothrinax readii, Cocos nucifera, Colpothrinax cookii, Cryosophila stauracantha, Desmoncus chinantlensis, Euterpe precatoria, Gaussia maya, Geonoma deversa, Geonoma interrupta, Geonoma pinnatifrons, Manicaria saccifera, Pseudophoenix sargentii, Reinhardtia gracilis, Reinhardtia latisecta, Roystonea regia, Sabal mauritiiformis, Sabal yapa, Schippia concolor, Synechanthus fibrosus, Thrinax radiata"
"BOL"	"Acrocomia totai, Aiphanes horrida, Aiphanes truncata, Allagoptera leucocalyx, Astrocaryum aculeatum, Astrocaryum arenarium, Astrocaryum chonta, Astrocaryum gratum, Astrocaryum huaimi, Astrocaryum jauari, Astrocaryum tucuma, Astrocaryum ulei, Attalea butyracea, Attalea eichleri, Attalea maripa, Attalea moorei, Attalea pacensis, Attalea phalerata, Attalea princeps, Attalea speciosa, Bactris acanthocarpa, Bactris brongniartii, Bactris chaveziae, Bactris concinna, Bactris corossilla, Bactris elegans, Bactris faucium, Bactris gasipaes, Bactris glaucescens, Bactris hirta, Bactris macroacantha, Bactris major, Bactris maraja, Bactris martiana, Bactris riparia, Bactris simplicifrons, Ceroxylon parvifrons, Ceroxylon pityrophyllum, Chamaedorea angustisecta, Chamaedorea linearis, Chamaedorea pauciflora, Chamaedorea pinnatifrons, Chelyocarpus chuco, Cocos nucifera, Copernicia alba, Desmoncus horridus, Desmoncus latisectus, Desmoncus mitis, Desmoncus polyacanthos, Dictyocaryum lamarckianum, Elaeis guineensis, Euterpe precatoria, Geonoma brongniartii, Geonoma deversa, Geonoma euspatha, Geonoma interrupta, Geonoma laxiflora, Geonoma leptospadix, Geonoma macrostachys, Geonoma maxima, Geonoma occidentalis, Geonoma orbignyana, Geonoma pohliana, Geonoma stricta, Geonoma undata, Hyospathe elegans, Iriartea deltoidea, Iriartella stenocarpa, Mauritia flexuosa, Mauritiella armata, Oenocarpus balickii, Oenocarpus bataua, Oenocarpus distichus, Oenocarpus mapora, Parajubaea sunkha, Parajubaea torallyi, Phoenix canariensis, Phoenix dactylifera, Phytelephas macrocarpa, Phytelephas tenuicaulis, Prestoea acuminata, Socratea exorrhiza, Socratea salazarii, Syagrus cardenasii, Syagrus comosa, Syagrus flexuosa, Syagrus oleracea, Syagrus petraea, Syagrus sancona, Syagrus yungasensis, Trithrinax schizophylla, Washingtonia filifera, Wendlandiella gracilis, Wettinia augusta"
"BOR"	"Adonidia dransfieldii, Adonidia merrillii, Areca abdulrahmanii, Areca ahmadii, Areca andersonii, Areca arundinacea, Areca bakeri, Areca brachypoda, Areca catechu, Areca chaiana, Areca churchii, Areca dayung, Areca dransfieldii, Areca furcata, Areca gurita, Areca insignis, Areca jugahpunya, Areca kinabaluensis, Areca klingkangensis, Areca minuta, Areca mogeana, Areca rheophytica, Areca subacaulis, Areca triandra, Areca vidaliana, Arenga brevipes, Arenga distincta, Arenga hastata, Arenga retroflorescens, Arenga undulatifolia, Borassodendron borneense, Calamus acamptostachys, Calamus acanthochlamys, Calamus ashtonii, Calamus asteracanthus, Calamus ater, Calamus axillaris, Calamus bacularis, Calamus banggiensis, Calamus billitonensis, Calamus caesius, Calamus collarifer, Calamus comptus, Calamus concolor, Calamus conirostris, Calamus conjugatus, Calamus conspectus, Calamus convallium, Calamus crassifolius, Calamus crinitus, Calamus cristatus, Calamus didymophyllus, Calamus diepenhorstii, Calamus divaricatus, Calamus draco, Calamus dumetosus, Calamus elongatus, Calamus erinaceus, Calamus erioacanthus, Calamus exilis, Calamus fissus, Calamus flabellatus, Calamus formicarius, Calamus gibbsianus, Calamus gonospermus, Calamus hallierianus, Calamus hirsutus, Calamus ingens, Calamus javensis, Calamus kiahii, Calamus korthalsii, Calamus lambirensis, Calamus leloi, Calamus lobbianus, Calamus longibracteatus, Calamus longipes, Calamus longistipes, Calamus maculatus, Calamus maiadum, Calamus malawaliensis, Calamus manan, Calamus marginatus, Calamus mattanensis, Calamus micracanthus, Calamus micranthus, Calamus microsphaerion, Calamus microstachys, Calamus mirabilis, Calamus moorei, Calamus moseleyanus, Calamus muricatus, Calamus myriacanthus, Calamus nanodendron, Calamus nematospadix, Calamus nielsenii, Calamus oblatus, Calamus optimus, Calamus ornatus, Calamus oxycoccus, Calamus pachyrostris, Calamus pandanosmus, Calamus paspalanthus, Calamus paulii, Calamus periacanthus, Calamus pilosellus, Calamus plicatus, Calamus poensis, Calamus pogonacanthus, Calamus pogonotium, Calamus psilocladus, Calamus pumilus, Calamus pygmaeus, Calamus rhomboideus, Calamus rhytidomus, Calamus ruptilis, Calamus ruvidus, Calamus sabalensis, Calamus sabensis, Calamus sabut, Calamus sarawakensis, Calamus scabridulus, Calamus scapigerus, Calamus schistoacanthus, Calamus scipionum, Calamus serpentinus, Calamus sordidus, Calamus sparsiflorus, Calamus spectatissimus, Calamus spinulinervis, Calamus subangulatus, Calamus tenompokensis, Calamus trachycoleus, Calamus unijugus, Calamus ursinus, Calamus usitatus, Calamus zonatus, Caryota mitis, Caryota no, Cocos nucifera, Corypha utan, Cyrtostachys renda, Eleiodoxa conferta, Eugeissona ambigua, Eugeissona insignis, Eugeissona minor, Eugeissona utilis, Iguanura ambigua, Iguanura borneensis, Iguanura chaiana, Iguanura curvata, Iguanura elegans, Iguanura macrostachya, Iguanura melinauensis, Iguanura minor, Iguanura myochodoides, Iguanura palmuncula, Iguanura prolifera, Iguanura remotiflora, Iguanura sanderiana, Johannesteijsmannia altifrons, Korthalsia angustifolia, Korthalsia cheb, Korthalsia concolor, Korthalsia debilis, Korthalsia echinometra, Korthalsia ferox, Korthalsia flagellaris, Korthalsia furcata, Korthalsia furtadoana, Korthalsia hispida, Korthalsia jala, Korthalsia paucijuga, Korthalsia rigida, Korthalsia robusta, Korthalsia rostrata, Licuala acuminata, Licuala atrovirens, Licuala bidentata, Licuala bintulensis, Licuala borneensis, Licuala bruneiana, Licuala burretii, Licuala campestris, Licuala chaiana, Licuala collina, Licuala cordata, Licuala densiflora, Licuala elliptica, Licuala exigua, Licuala flammula, Licuala glabra, Licuala hallieriana, Licuala intermedia, Licuala kuchingensis, Licuala lambii, Licuala lanata, Licuala leopoldii, Licuala leucocarpa, Licuala maculata, Licuala mattanensis, Licuala meijeri, Licuala micholitzii, Licuala miriensis, Licuala mukahensis, Licuala olivifera, Licuala oliviformis, Licuala orbicularis, Licuala oryzoides, Licuala paludosa, Licuala petiolulata, Licuala pilosa, Licuala pseudovalida, Licuala punctulata, Licuala reptans, Licuala rheophytica, Licuala rubiginosa, Licuala sabahana, Licuala sarawakensis, Licuala spathellifera, Licuala spicata, Licuala spinosa, Licuala triphylla, Licuala yiiana, Livistona exigua, Livistona saribus, Metroxylon sagu, Nenga gajah, Nenga pumila, Nypa fruticans, Oncosperma horridum, Oncosperma tigillarium, Orania paraguanensis, Orania sylvicola, Pholidocarpus majadum, Pinanga albescens, Pinanga angustisecta, Pinanga aristata, Pinanga arundinacea, Pinanga auriculata, Pinanga borneensis, Pinanga brevipes, Pinanga capitata, Pinanga chaiana, Pinanga crassipes, Pinanga cucullata, Pinanga decora, Pinanga dumetosa, Pinanga gracillima, Pinanga jambusana, Pinanga keahii, Pinanga lepidota, Pinanga ligulata, Pinanga limbangensis, Pinanga minuta, Pinanga mirabilis, Pinanga mooreana, Pinanga pachyphylla, Pinanga pilosa, Pinanga ridleyana, Pinanga rivularis, Pinanga rupestris, Pinanga salicifolia, Pinanga sessilifolia, Pinanga sibuyanensis, Pinanga simplicifrons, Pinanga stricta, Pinanga tenacinervis, Pinanga tenella, Pinanga tomentella, Pinanga trichoneura, Pinanga variegata, Pinanga veitchii, Pinanga yassinii, Plectocomia elongata, Plectocomia mulleri, Plectocomia pygmaea, Plectocomiopsis geminiflora, Plectocomiopsis mira, Plectocomiopsis triquetra, Salacca affinis, Salacca bakeriana, Salacca clemensiana, Salacca dolicholepis, Salacca dransfieldiana, Salacca magnifica, Salacca ramosiana, Salacca rupicola, Salacca sarawakensis, Salacca vermicularis, Salacca zalacca, Saribus rotundifolius"
"BOT"	"Hyphaene petersiana, Phoenix reclinata"
"BOU"	"NA"
"BRC"	"NA"
"BRY"	"NA"
"BUL"	"NA"
"BUR"	"Elaeis guineensis, Eremospatha haullevilleana, Hyphaene petersiana, Phoenix reclinata, Raphia ruwenzorica"
"BZC"	"Acrocomia aculeata, Acrocomia emensis, Acrocomia glaucescens, Acrocomia hassleri, Acrocomia totai, Allagoptera campestris, Allagoptera leucocalyx, Allagoptera robusta, Astrocaryum arenarium, Astrocaryum campestre, Astrocaryum echinatum, Astrocaryum huaimi, Astrocaryum vulgare, Attalea anisitsiana, Attalea apoda, Attalea barreirensis, Attalea brasiliensis, Attalea butyracea, Attalea exigua, Attalea geraensis, Attalea hoehnei, Attalea maripa, Attalea phalerata, Attalea speciosa, Bactris bidentula, Bactris brongniartii, Bactris gasipaes, Bactris glaucescens, Bactris major, Bactris maraja, Butia archeri, Butia campicola, Butia capitata, Butia exospadix, Butia lepidotispatha, Butia leptospatha, Butia matogrossensis, Butia paraguayensis, Butia purpurascens, Chamaedorea pauciflora, Copernicia alba, Desmoncus horridus, Desmoncus leptoclonos, Desmoncus mitis, Euterpe edulis, Euterpe longibracteata, Geonoma pohliana, Iriartea deltoidea, Mauritia flexuosa, Mauritiella armata, Oenocarpus bataua, Oenocarpus distichus, Syagrus allagopteroides, Syagrus caerulescens, Syagrus campylospatha, Syagrus cerqueirana, Syagrus cocoides, Syagrus comosa, Syagrus deflexa, Syagrus emasensis, Syagrus flexuosa, Syagrus glazioviana, Syagrus graminifolia, Syagrus guimaraesensis, Syagrus lilliputiana, Syagrus loefgrenii, Syagrus longipedunculata, Syagrus menzeliana, Syagrus oleracea, Syagrus pleiocladoides, Syagrus pompeoi, Syagrus procumbens, Syagrus romanzoffiana, Syagrus rupicola, Syagrus vermicularis, Trithrinax schizophylla"
"BZE"	"Acrocomia aculeata, Acrocomia intumescens, Allagoptera arenaria, Allagoptera brevicalyx, Allagoptera campestris, Allagoptera caudescens, Allagoptera leucocalyx, Astrocaryum aculeatissimum, Astrocaryum aculeatum, Astrocaryum campestre, Astrocaryum vulgare, Attalea barreirensis, Attalea brejinhoensis, Attalea burretiana, Attalea eichleri, Attalea exigua, Attalea funifera, Attalea geraensis, Attalea humilis, Attalea maripa, Attalea oleifera, Attalea pindobassu, Attalea salvadorensis, Attalea seabrensis, Attalea speciosa, Attalea vitrivir, Bactris acanthocarpa, Bactris bahiensis, Bactris brongniartii, Bactris campestris, Bactris caryotifolia, Bactris ferruginea, Bactris glassmanii, Bactris hirta, Bactris horridispatha, Bactris major, Bactris pickelii, Bactris setosa, Bactris simplicifrons, Bactris soeiroana, Bactris tomentosa, Bactris vulgaris, Butia capitata, Cocos nucifera, Copernicia prunifera, Desmoncus horridus, Desmoncus orthacanthos, Desmoncus polyacanthos, Euterpe edulis, Euterpe oleracea, Geonoma baculifera, Geonoma elegans, Geonoma leptospadix, Geonoma pauciflora, Geonoma pohliana, Mauritia flexuosa, Mauritiella armata, Oenocarpus distichus, Socratea exorrhiza, Syagrus allagopteroides, Syagrus botryophora, Syagrus cearensis, Syagrus cocoides, Syagrus comosa, Syagrus coronata, Syagrus flexuosa, Syagrus glazioviana, Syagrus harleyi, Syagrus inajai, Syagrus itapebiensis, Syagrus lorenzoniorum, Syagrus microphylla, Syagrus oleracea, Syagrus romanzoffiana, Syagrus santosii, Syagrus schizophylla, Syagrus vagans, Syagrus vermicularis, Syagrus werdermannii"
"BZL"	"Acrocomia aculeata, Acrocomia emensis, Allagoptera arenaria, Allagoptera campestris, Allagoptera caudescens, Allagoptera leucocalyx, Astrocaryum aculeatissimum, Astrocaryum campestre, Attalea amylacea, Attalea apoda, Attalea burretiana, Attalea compta, Attalea dubia, Attalea exigua, Attalea funifera, Attalea geraensis, Attalea humilis, Attalea lauromuelleriana, Attalea phalerata, Attalea speciosa, Attalea vitrivir, Bactris acanthocarpa, Bactris bahiensis, Bactris caryotifolia, Bactris ferruginea, Bactris glaucescens, Bactris hatschbachii, Bactris hirta, Bactris pickelii, Bactris setosa, Bactris timbuiensis, Bactris vulgaris, Butia archeri, Butia capitata, Butia microspadix, Butia paraguayensis, Butia purpurascens, Cocos nucifera, Copernicia prunifera, Desmoncus leptoclonos, Desmoncus orthacanthos, Desmoncus polyacanthos, Euterpe edulis, Geonoma elegans, Geonoma pauciflora, Geonoma pohliana, Geonoma schottiana, Mauritia flexuosa, Mauritiella armata, Syagrus allagopteroides, Syagrus angustifolia, Syagrus botryophora, Syagrus campestris, Syagrus comosa, Syagrus coronata, Syagrus duartei, Syagrus evansiana, Syagrus flexuosa, Syagrus glaucescens, Syagrus glazioviana, Syagrus gouveiana, Syagrus graminifolia, Syagrus hoehnei, Syagrus insignis, Syagrus itacambirana, Syagrus kellyana, Syagrus loefgrenii, Syagrus lorenzoniorum, Syagrus macrocarpa, Syagrus mendanhensis, Syagrus minor, Syagrus oleracea, Syagrus picrophylla, Syagrus pleioclada, Syagrus pseudococos, Syagrus romanzoffiana, Syagrus ruschiana, Syagrus schizophylla, Syagrus vagans, Syagrus weddelliana"
"BZN"	"Acrocomia aculeata, Aiphanes deltoidea, Aiphanes horrida, Aiphanes ulei, Allagoptera campestris, Allagoptera leucocalyx, Aphandra natalia, Astrocaryum acaule, Astrocaryum aculeatum, Astrocaryum campestre, Astrocaryum chambira, Astrocaryum ciliatum, Astrocaryum faranae, Astrocaryum farinosum, Astrocaryum ferrugineum, Astrocaryum giganteum, Astrocaryum jauari, Astrocaryum javarense, Astrocaryum minus, Astrocaryum murumuru, Astrocaryum paramaca, Astrocaryum rodriguesii, Astrocaryum sciophilum, Astrocaryum sociale, Astrocaryum tucuma, Astrocaryum ulei, Astrocaryum vulgare, Attalea attaleoides, Attalea butyracea, Attalea dahlgreniana, Attalea eichleri, Attalea huebneri, Attalea insignis, Attalea luetzelburgii, Attalea maripa, Attalea microcarpa, Attalea phalerata, Attalea plowmanii, Attalea princeps, Attalea racemosa, Attalea speciosa, Attalea spectabilis, Attalea tessmannii, Bactris acanthocarpa, Bactris acanthocarpoides, Bactris balanophora, Bactris bidentula, Bactris bifida, Bactris brongniartii, Bactris campestris, Bactris chaveziae, Bactris concinna, Bactris constanciae, Bactris corossilla, Bactris cuspidata, Bactris elegans, Bactris fissifrons, Bactris gasipaes, Bactris gastoniana, Bactris glaucescens, Bactris halmoorei, Bactris hirta, Bactris killipii, Bactris macroacantha, Bactris major, Bactris maraja, Bactris martiana, Bactris nancibaensis, Bactris oligocarpa, Bactris pliniana, Bactris rhaphidacantha, Bactris riparia, Bactris simplicifrons, Bactris sphaerocarpa, Bactris syagroides, Bactris tefensis, Bactris tomentosa, Bactris turbinocarpa, Barcella odora, Chamaedorea angustisecta, Chamaedorea pauciflora, Chamaedorea pinnatifrons, Chelyocarpus chuco, Chelyocarpus ulei, Cocos nucifera, Copernicia prunifera, Desmoncus giganteus, Desmoncus horridus, Desmoncus leptoclonos, Desmoncus mitis, Desmoncus parvulus, Desmoncus polyacanthos, Desmoncus pumilus, Desmoncus setosus, Desmoncus vacivus, Dictyocaryum ptarianum, Elaeis oleifera, Euterpe catinga, Euterpe longibracteata, Euterpe oleracea, Euterpe precatoria, Geonoma aspidiifolia, Geonoma baculifera, Geonoma brongniartii, Geonoma camana, Geonoma deversa, Geonoma euspatha, Geonoma laxiflora, Geonoma leptospadix, Geonoma macrostachys, Geonoma maxima, Geonoma occidentalis, Geonoma oldemanii, Geonoma oligoclona, Geonoma poeppigiana, Geonoma poiteauana, Geonoma stricta, Geonoma umbraculiformis, Geonoma undata, Hyospathe elegans, Iriartea deltoidea, Iriartella setigera, Iriartella stenocarpa, Itaya amicorum, Leopoldinia piassaba, Leopoldinia pulchra, Lepidocaryum tenue, Manicaria martiana, Manicaria saccifera, Mauritia carana, Mauritia flexuosa, Mauritiella aculeata, Mauritiella armata, Oenocarpus bacaba, Oenocarpus balickii, Oenocarpus bataua, Oenocarpus circumtextus, Oenocarpus distichus, Oenocarpus mapora, Oenocarpus minor, Oenocarpus simplex, Pholidostachys synanthera, Phytelephas macrocarpa, Prestoea schultzeana, Prestoea tenuiramosa, Raphia taedigera, Socratea exorrhiza, Socratea salazarii, Syagrus allagopteroides, Syagrus cocoides, Syagrus comosa, Syagrus flexuosa, Syagrus glazioviana, Syagrus graminifolia, Syagrus inajai, Syagrus oleracea, Syagrus orinocensis, Syagrus sancona, Syagrus smithii, Syagrus stratincola, Syagrus vermicularis, Wendlandiella gracilis, Wettinia augusta, Wettinia drudei"
"BZS"	"Acrocomia emensis, Acrocomia totai, Allagoptera arenaria, Allagoptera campestris, Allagoptera leucocalyx, Astrocaryum aculeatissimum, Attalea dubia, Bactris hatschbachii, Bactris setosa, Bactris vulgaris, Butia catarinensis, Butia eriospatha, Butia exilata, Butia lallemantii, Butia microspadix, Butia odorata, Butia paraguayensis, Butia pubispatha, Butia witeckii, Butia yatay, Euterpe edulis, Geonoma elegans, Geonoma pohliana, Geonoma schottiana, Syagrus hoehnei, Syagrus oleracea, Syagrus romanzoffiana, Trithrinax brasiliensis"
"CAB"	"Eremospatha cabrae, Eremospatha haullevilleana, Eremospatha wendlandiana, Hyphaene guineensis, Laccosperma laeve, Laccosperma robustum, Oncocalamus macrospathus, Podococcus barteri, Raphia matombe, Raphia palma-pinus, Raphia regalis, Raphia rostrata, Raphia textilis, Sclerosperma mannii"
"CAF"	"Borassus aethiopum, Borassus akeassii, Calamus deerratus, Cocos nucifera, Elaeis guineensis, Eremospatha cabrae, Eremospatha cuspidata, Eremospatha haullevilleana, Eremospatha hookeri, Eremospatha laurentii, Eremospatha macrocarpa, Eremospatha wendlandiana, Hyphaene thebaica, Laccosperma opacum, Laccosperma robustum, Laccosperma secundiflorum, Phoenix dactylifera, Phoenix reclinata, Raphia gentiliana, Raphia hookeri, Raphia laurentii, Raphia mambillensis, Raphia monbuttorum, Raphia regalis, Raphia vinifera"
"CAL"	"Phoenix dactylifera, Washingtonia filifera, Washingtonia robusta"
"CAY"	"Coccothrinax proctorii, Cocos nucifera, Phoenix dactylifera, Roystonea regia, Thrinax radiata"
"CBD"	"Areca catechu, Areca riparia, Areca triandra, Arenga caudata, Arenga pinnata, Arenga westerhoutii, Borassus flabellifer, Calamus acanthophyllus, Calamus bousigonii, Calamus erinaceus, Calamus godefroyi, Calamus jenkinsianus, Calamus kampucheaensis, Calamus lateralis, Calamus latifolius, Calamus melanacanthos, Calamus nitidus, Calamus rudentum, Calamus salicifolius, Calamus tenuis, Calamus tetradactylus, Calamus viminalis, Caryota mitis, Caryota sympetala, Cocos nucifera, Corypha lecomtei, Corypha umbraculifera, Corypha utan, Korthalsia bejaudii, Korthalsia laciniosa, Licuala paludosa, Licuala spinosa, Livistona saribus, Myrialepis paradoxa, Nypa fruticans, Oncosperma tigillarium, Phoenix loureiroi, Phoenix paludosa, Pinanga sylvestris, Plectocomia elongata, Plectocomia pierreana, Plectocomiopsis geminiflora, Rhapis subtilis"
"CGS"	"Cocos nucifera"
"CHA"	"Borassus aethiopum, Elaeis guineensis, Hyphaene thebaica, Phoenix dactylifera, Raphia monbuttorum"
"CHC"	"Areca catechu, Areca triandra, Arenga pinnata, Arenga westerhoutii, Borassus flabellifer, Calamus acanthospathus, Calamus albidus, Calamus erectus, Calamus flagellum, Calamus gracilis, Calamus henryanus, Calamus inermis, Calamus oxycarpus, Calamus rhabdocladus, Calamus viminalis, Calamus wuliangshanensis, Caryota maxima, Caryota monostachya, Caryota obtusa, Caryota urens, Cocos nucifera, Guihaia argyrata, Lanonia dasyantha, Livistona saribus, Livistona speciosa, Phoenix dactylifera, Phoenix roebelenii, Pinanga acuminata, Pinanga baviensis, Pinanga sylvestris, Plectocomia assamica, Plectocomia himalayana, Plectocomia pierreana, Rhapis excelsa, Rhapis humilis, Salacca griffithii, Trachycarpus fortunei, Trachycarpus martianus, Trachycarpus nanus, Trachycarpus princeps, Wallichia caryotoides, Wallichia disticha, Wallichia gracilis, Wallichia oblongifolia"
"CHH"	"Areca catechu, Arenga caudata, Arenga pinnata, Arenga westerhoutii, Calamus egregius, Calamus inermis, Calamus jenkinsianus, Calamus multispicatus, Calamus rhabdocladus, Calamus tetradactyloides, Calamus tetradactylus, Calamus walkeri, Caryota maxima, Caryota mitis, Chuniophoenix hainanensis, Chuniophoenix nana, Cocos nucifera, Lanonia hainanensis, Licuala fordiana, Livistona chinensis, Livistona speciosa, Nypa fruticans, Phoenix loureiroi, Pinanga baviensis, Plectocomia microstachys, Rhapis excelsa, Rhapis gracilis"
"CHI"	"NA"
"CHM"	"NA"
"CHN"	"NA"
"CHQ"	"NA"
"CHS"	"Areca triandra, Arenga caudata, Arenga longicarpa, Arenga pinnata, Arenga westerhoutii, Calamus compsostachys, Calamus dianbaiensis, Calamus flagellum, Calamus henryanus, Calamus inermis, Calamus jenkinsianus, Calamus macrorhynchus, Calamus melanochrous, Calamus oxycarpus, Calamus rhabdocladus, Calamus tetradactylus, Calamus thysanolepis, Calamus walkeri, Caryota maxima, Caryota mitis, Caryota monostachya, Caryota urens, Cocos nucifera, Guihaia argyrata, Guihaia grossifibrosa, Guihaia lancifolia, Lanonia dasyantha, Licuala fordiana, Livistona chinensis, Livistona saribus, Livistona speciosa, Phoenix dactylifera, Phoenix loureiroi, Phoenix sylvestris, Pinanga baviensis, Plectocomia pierreana, Rhapis excelsa, Rhapis gracilis, Rhapis humilis, Rhapis robusta, Wallichia gracilis"
"CHT"	"Arenga micrantha, Calamus acanthospathus, Calamus flagellum, Pinanga gracilis, Wallichia triandra"
"CHX"	"NA"
"CKI"	"Cocos nucifera"
"CLC"	"Jubaea chilensis"
"CLM"	"Acoelorrhaphe wrightii, Acrocomia aculeata, Aiphanes acaulis, Aiphanes argos, Aiphanes buenaventurae, Aiphanes concinna, Aiphanes deltoidea, Aiphanes duquei, Aiphanes erinacea, Aiphanes gelatinosa, Aiphanes graminifolia, Aiphanes hirsuta, Aiphanes horrida, Aiphanes killipii, Aiphanes leiostachys, Aiphanes lindeniana, Aiphanes linearis, Aiphanes macroloba, Aiphanes multiplex, Aiphanes parvifolia, Aiphanes pilaris, Aiphanes simplex, Aiphanes tricuspidata, Aiphanes ulei, Ammandra decasperma, Asterogyne martiana, Astrocaryum acaule, Astrocaryum aculeatum, Astrocaryum alatum, Astrocaryum chambira, Astrocaryum ciliatum, Astrocaryum ferrugineum, Astrocaryum jauari, Astrocaryum macrocalyx, Astrocaryum malybo, Astrocaryum standleyanum, Astrocaryum triandrum, Astrocaryum tucuma, Astrocaryum urostachys, Attalea allenii, Attalea amygdalina, Attalea butyracea, Attalea cohune, Attalea colenda, Attalea cuatrecasasiana, Attalea fairchildensis, Attalea iguadummat, Attalea insignis, Attalea luetzelburgii, Attalea magdalenica, Attalea maracaibensis, Attalea maripa, Attalea microcarpa, Attalea nucifera, Attalea phalerata, Attalea plowmanii, Attalea racemosa, Attalea septuagenata, Bactris acanthocarpa, Bactris balanophora, Bactris barronis, Bactris bidentula, Bactris bifida, Bactris brongniartii, Bactris campestris, Bactris charnleyae, Bactris chocoensis, Bactris coloniata, Bactris coloradonis, Bactris concinna, Bactris corossilla, Bactris elegans, Bactris fissifrons, Bactris gasipaes, Bactris glandulosa, Bactris guineensis, Bactris halmoorei, Bactris hirta, Bactris killipii, Bactris macroacantha, Bactris major, Bactris manriquei, Bactris maraja, Bactris martiana, Bactris obovata, Bactris pilosa, Bactris riparia, Bactris rostrata, Bactris schultesii, Bactris setulosa, Bactris simplicifrons, Bactris sphaerocarpa, Calyptrogyne baudensis, Calyptrogyne costatifrons, Ceroxylon alpinum, Ceroxylon ceriferum, Ceroxylon parvifrons, Ceroxylon quindiuense, Ceroxylon sasaimae, Ceroxylon ventricosum, Ceroxylon vogelianum, Chamaedorea allenii, Chamaedorea christinae, Chamaedorea deneversiana, Chamaedorea linearis, Chamaedorea pauciflora, Chamaedorea pinnatifrons, Chamaedorea ponderosa, Chamaedorea pumila, Chamaedorea pygmaea, Chamaedorea ricardoi, Chamaedorea subjectifolia, Chamaedorea tepejilote, Chamaedorea warscewiczii, Chamaedorea woodsoniana, Chelyocarpus dianeurus, Chelyocarpus repens, Chelyocarpus ulei, Coccothrinax argentata, Cocos nucifera, Copernicia tectorum, Cryosophila kalbreyeri, Cryosophila macrocarpa, Desmoncus cirrhifer, Desmoncus giganteus, Desmoncus horridus, Desmoncus interjectus, Desmoncus mitis, Desmoncus myriacanthos, Desmoncus parvulus, Desmoncus polyacanthos, Desmoncus pumilus, Desmoncus setosus, Desmoncus vacivus, Dictyocaryum lamarckianum, Dictyocaryum ptarianum, Elaeis oleifera, Euterpe catinga, Euterpe oleracea, Euterpe precatoria, Geonoma baculifera, Geonoma bernalii, Geonoma brongniartii, Geonoma calyptrogynoidea, Geonoma camana, Geonoma chlamydostachys, Geonoma chococola, Geonoma concinna, Geonoma cuneata, Geonoma deversa, Geonoma dindoensis, Geonoma divisa, Geonoma euspatha, Geonoma fosteri, Geonoma frontinensis, Geonoma galeanoae, Geonoma gentryi, Geonoma interrupta, Geonoma lanata, Geonoma laxiflora, Geonoma lehmannii, Geonoma leptospadix, Geonoma longepedunculata, Geonoma macrostachys, Geonoma maxima, Geonoma multisecta, Geonoma oligoclona, Geonoma orbignyana, Geonoma paradoxa, Geonoma pinnatifrons, Geonoma poeppigiana, Geonoma poiteauana, Geonoma santanderensis, Geonoma stricta, Geonoma triandra, Geonoma triglochin, Geonoma undata, Hyospathe elegans, Hyospathe frontinensis, Hyospathe pittieri, Hyospathe wendlandiana, Iriartea deltoidea, Iriartella setigera, Iriartella stenocarpa, Itaya amicorum, Leopoldinia piassaba, Leopoldinia pulchra, Lepidocaryum tenue, Manicaria martiana, Manicaria saccifera, Mauritia carana, Mauritia flexuosa, Mauritiella aculeata, Mauritiella armata, Mauritiella macroclada, Mauritiella pumila, Oenocarpus bacaba, Oenocarpus balickii, Oenocarpus bataua, Oenocarpus circumtextus, Oenocarpus makeru, Oenocarpus mapora, Oenocarpus minor, Oenocarpus simplex, Parajubaea cocoides, Pholidostachys dactyloides, Pholidostachys occidentalis, Pholidostachys panamensis, Pholidostachys pulchra, Pholidostachys sanluisensis, Pholidostachys synanthera, Phytelephas macrocarpa, Phytelephas tenuicaulis, Phytelephas tumacana, Prestoea acuminata, Prestoea carderi, Prestoea decurrens, Prestoea ensiformis, Prestoea longepetiolata, Prestoea pubens, Prestoea schultzeana, Prestoea simplicifolia, Raphia taedigera, Reinhardtia gracilis, Reinhardtia koschnyana, Reinhardtia simplex, Roystonea oleracea, Sabal mauritiiformis, Sabinaria magnifica, Socratea exorrhiza, Socratea hecatonandra, Socratea rostrata, Syagrus orinocensis, Syagrus sancona, Syagrus smithii, Synechanthus warscewiczianus, Welfia regia, Wettinia aequalis, Wettinia anomala, Wettinia augusta, Wettinia castanea, Wettinia disticha, Wettinia drudei, Wettinia fascicularis, Wettinia hirsuta, Wettinia kalbreyeri, Wettinia lanata, Wettinia maynensis, Wettinia microcarpa, Wettinia oxycarpa, Wettinia praemorsa, Wettinia quinaria, Wettinia radiata, Wettinia verruculosa"
"CLN"	"Cocos nucifera"
"CLS"	"NA"
"CMN"	"Borassus aethiopum, Calamus deerratus, Cocos nucifera, Elaeis guineensis, Eremospatha barendii, Eremospatha cuspidata, Eremospatha haullevilleana, Eremospatha hookeri, Eremospatha laurentii, Eremospatha macrocarpa, Eremospatha quinquecostulata, Eremospatha tessmanniana, Eremospatha wendlandiana, Hyphaene thebaica, Laccosperma acutiflorum, Laccosperma korupense, Laccosperma laeve, Laccosperma opacum, Laccosperma robustum, Laccosperma secundiflorum, Nypa fruticans, Oncocalamus macrospathus, Oncocalamus mannii, Oncocalamus tuleyi, Phoenix reclinata, Podococcus barteri, Raphia africana, Raphia farinifera, Raphia hookeri, Raphia longiflora, Raphia mambillensis, Raphia monbuttorum, Raphia palma-pinus, Raphia regalis, Raphia sudanica, Raphia taedigera, Raphia vinifera, Sclerosperma mannii"
"CNT"	"NA"
"CNY"	"Phoenix canariensis, Phoenix dactylifera, Washingtonia robusta"
"COL"	"NA"
"COM"	"Borassus aethiopum, Caryota mitis, Dypsis cabadae, Dypsis humblotiana, Dypsis lanceolata, Elaeis guineensis, Phoenix reclinata, Ravenea hildebrandtii, Ravenea moorei"
"CON"	"Borassus aethiopum, Calamus deerratus, Elaeis guineensis, Eremospatha cabrae, Eremospatha cuspidata, Eremospatha haullevilleana, Eremospatha hookeri, Eremospatha laurentii, Eremospatha tessmanniana, Eremospatha wendlandiana, Hyphaene guineensis, Hyphaene thebaica, Laccosperma korupense, Laccosperma laeve, Laccosperma opacum, Laccosperma secundiflorum, Oncocalamus macrospathus, Oncocalamus mannii, Phoenix reclinata, Podococcus acaulis, Podococcus barteri, Raphia farinifera, Raphia hookeri, Raphia palma-pinus, Raphia sudanica, Sclerosperma mannii, Sclerosperma profizianum"
"COO"	"Adonidia merrillii, Cocos nucifera, Pritchardia mitiaroana, Pritchardia pacifica"
"COR"	"Chamaerops humilis"
"COS"	"Acoelorrhaphe wrightii, Acrocomia aculeata, Aiphanes hirsuta, Asterogyne martiana, Astrocaryum alatum, Astrocaryum confertum, Astrocaryum standleyanum, Attalea rostrata, Bactris ana-juliae, Bactris caudata, Bactris coloradonis, Bactris dianeura, Bactris gasipaes, Bactris glandulosa, Bactris gracilior, Bactris grayumii, Bactris guineensis, Bactris herrerana, Bactris longiseta, Bactris major, Bactris maraja, Bactris militaris, Bactris obovata, Bactris polystachya, Calyptrogyne condensata, Calyptrogyne ghiesbreghtiana, Calyptrogyne herrerae, Calyptrogyne osensis, Calyptrogyne trichostachys, Chamaedorea amabilis, Chamaedorea anemophila, Chamaedorea binderi, Chamaedorea brachyclada, Chamaedorea costaricana, Chamaedorea crucensis, Chamaedorea dammeriana, Chamaedorea deckeriana, Chamaedorea deneversiana, Chamaedorea geonomiformis, Chamaedorea graminifolia, Chamaedorea hodelii, Chamaedorea incrustata, Chamaedorea lucidifrons, Chamaedorea macrospadix, Chamaedorea matae, Chamaedorea palmeriana, Chamaedorea parvifolia, Chamaedorea pedunculata, Chamaedorea pinnatifrons, Chamaedorea piscifolia, Chamaedorea pittieri, Chamaedorea pumila, Chamaedorea pygmaea, Chamaedorea robertii, Chamaedorea rosibeliae, Chamaedorea rossteniorum, Chamaedorea scheryi, Chamaedorea stenocarpa, Chamaedorea stricta, Chamaedorea tepejilote, Chamaedorea undulatifolia, Chamaedorea warscewiczii, Chamaedorea woodsoniana, Chamaedorea zamorae, Cocos nucifera, Colpothrinax aphanopetala, Cryosophila cookii, Cryosophila grayumii, Cryosophila guagara, Cryosophila warscewiczii, Desmoncus costaricensis, Desmoncus moorei, Desmoncus osensis, Desmoncus stans, Elaeis guineensis, Elaeis oleifera, Euterpe precatoria, Geonoma brenesii, Geonoma congesta, Geonoma cuneata, Geonoma deversa, Geonoma epetiolata, Geonoma ferruginea, Geonoma interrupta, Geonoma longivaginata, Geonoma monospatha, Geonoma orbignyana, Geonoma pinnatifrons, Geonoma scoparia, Geonoma talamancana, Geonoma undata, Hyospathe elegans, Iriartea deltoidea, Manicaria saccifera, Neonicholsonia watsonii, Oenocarpus mapora, Pholidostachys pulchra, Prestoea acuminata, Prestoea decurrens, Prestoea ensiformis, Prestoea longepetiolata, Prestoea schultzeana, Raphia taedigera, Reinhardtia gracilis, Reinhardtia koschnyana, Reinhardtia latisecta, Reinhardtia simplex, Sabal mauritiiformis, Socratea exorrhiza, Synechanthus fibrosus, Synechanthus warscewiczianus, Welfia regia"
"CPI"	"Cocos nucifera, Euterpe precatoria"
"CPP"	"Jubaeopsis caffra, Phoenix reclinata, Raphia australis"
"CPV"	"Hyphaene petersiana, Phoenix reclinata"
"CRL"	"Areca catechu, Clinostigma carolinense, Clinostigma ponapense, Cocos nucifera, Elaeis guineensis, Heterospathe elata, Hydriastele palauensis, Metroxylon amicarum, Nypa fruticans, Pinanga insignis, Ponapea hosinoi, Ponapea ledermanniana, Ponapea palauensis"
"CRZ"	"NA"
"CTA"	"NA"
"CTM"	"Rhopalostylis sapida"
"CUB"	"Acoelorrhaphe wrightii, Acrocomia aculeata, Acrocomia crispa, Bactris cubensis, Calyptronoma occidentalis, Calyptronoma plumeriana, Caryota urens, Coccothrinax acunana, Coccothrinax alexandri, Coccothrinax baracoensis, Coccothrinax bermudezii, Coccothrinax borhidiana, Coccothrinax camagueyana, Coccothrinax clarensis, Coccothrinax crinita, Coccothrinax cupularis, Coccothrinax elegans, Coccothrinax fagildei, Coccothrinax fragrans, Coccothrinax garciana, Coccothrinax guantanamensis, Coccothrinax gundlachii, Coccothrinax hioramii, Coccothrinax leonis, Coccothrinax litoralis, Coccothrinax macroglossa, Coccothrinax microphylla, Coccothrinax miraguama, Coccothrinax moaensis, Coccothrinax munizii, Coccothrinax muricata, Coccothrinax nipensis, Coccothrinax orientalis, Coccothrinax pauciramosa, Coccothrinax pseudorigida, Coccothrinax pumila, Coccothrinax rigida, Coccothrinax salvatoris, Coccothrinax saxicola, Coccothrinax torrida, Coccothrinax trinitensis, Coccothrinax victorinii, Coccothrinax yunquensis, Coccothrinax yuraguana, Cocos nucifera, Colpothrinax wrightii, Copernicia baileyana, Copernicia brittonorum, Copernicia cowellii, Copernicia curbeloi, Copernicia curtissii, Copernicia fallaensis, Copernicia gigas, Copernicia glabrescens, Copernicia hospita, Copernicia humicola, Copernicia longiglossa, Copernicia macroglossa, Copernicia molinetii, Copernicia oxycalyx, Copernicia rigida, Copernicia roigii, Copernicia yarey, Gaussia princeps, Gaussia spirituana, Hemithrinax compacta, Hemithrinax ekmaniana, Hemithrinax rivularis, Leucothrinax morrisii, Phoenix rupicola, Prestoea acuminata, Pseudophoenix sargentii, Roystonea lenis, Roystonea maisiana, Roystonea regia, Roystonea violacea, Sabal domingensis, Sabal maritima, Sabal palmetto, Sabal yapa, Thrinax radiata"
"CVI"	"Phoenix atlantica, Phoenix dactylifera"
"CYP"	"Washingtonia filifera"
"CZE"	"NA"
"DEL"	"NA"
"DEN"	"NA"
"DJI"	"Hyphaene thebaica, Livistona carinensis, Phoenix caespitosa, Phoenix reclinata"
"DOM"	"Acrocomia aculeata, Adonidia merrillii, Aiphanes acanthophylla, Areca catechu, Bactris plumeriana, Calyptronoma plumeriana, Calyptronoma rivalis, Caryota mitis, Caryota urens, Chamaerops humilis, Coccothrinax argentea, Coccothrinax boschiana, Coccothrinax ekmanii, Coccothrinax fragrans, Coccothrinax gracilis, Coccothrinax jimenezii, Coccothrinax montana, Coccothrinax scoparia, Coccothrinax spissa, Cocos nucifera, Copernicia berteroana, Dypsis lutescens, Elaeis guineensis, Gaussia attenuata, Howea forsteriana, Livistona chinensis, Manicaria saccifera, Phoenix dactylifera, Prestoea acuminata, Pseudophoenix ekmanii, Pseudophoenix sargentii, Pseudophoenix vinifera, Ptychosperma elegans, Ptychosperma macarthurii, Reinhardtia paiewonskiana, Roystonea borinquena, Roystonea regia, Sabal causiarum, Sabal domingensis, Thrinax radiata, Zombia antillarum"
"DSV"	"NA"
"EAI"	"Phoenix dactylifera, Phoenix theophrasti, Washingtonia filifera"
"EAS"	"Cocos nucifera"
"ECU"	"Aiphanes bicornis, Aiphanes chiribogensis, Aiphanes eggersii, Aiphanes erinacea, Aiphanes gelatinosa, Aiphanes grandis, Aiphanes hirsuta, Aiphanes macroloba, Aiphanes tricuspidata, Aiphanes ulei, Aiphanes verrucosa, Aiphanes weberbaueri, Ammandra decasperma, Aphandra natalia, Asterogyne martiana, Astrocaryum chambira, Astrocaryum jauari, Astrocaryum standleyanum, Astrocaryum urostachys, Attalea butyracea, Attalea colenda, Attalea insignis, Attalea maripa, Bactris acanthocarpa, Bactris coloniata, Bactris coloradonis, Bactris concinna, Bactris corossilla, Bactris fissifrons, Bactris gasipaes, Bactris halmoorei, Bactris major, Bactris maraja, Bactris martiana, Bactris obovata, Bactris pilosa, Bactris riparia, Bactris schultesii, Bactris setiflora, Bactris setulosa, Bactris simplicifrons, Ceroxylon amazonicum, Ceroxylon echinulatum, Ceroxylon parvifrons, Ceroxylon parvum, Ceroxylon ventricosum, Ceroxylon vogelianum, Chamaedorea deneversiana, Chamaedorea linearis, Chamaedorea pauciflora, Chamaedorea pinnatifrons, Chelyocarpus ulei, Desmoncus cirrhifer, Desmoncus giganteus, Desmoncus horridus, Desmoncus mitis, Desmoncus polyacanthos, Dictyocaryum lamarckianum, Elaeis oleifera, Euterpe oleracea, Euterpe precatoria, Geonoma brongniartii, Geonoma calyptrogynoidea, Geonoma camana, Geonoma chococola, Geonoma cuneata, Geonoma deversa, Geonoma euspatha, Geonoma fosteri, Geonoma hollinensis, Geonoma interrupta, Geonoma lanata, Geonoma laxiflora, Geonoma lehmannii, Geonoma leptospadix, Geonoma longepedunculata, Geonoma macrostachys, Geonoma maxima, Geonoma multisecta, Geonoma orbignyana, Geonoma paradoxa, Geonoma pinnatifrons, Geonoma poeppigiana, Geonoma stricta, Geonoma tenuissima, Geonoma triandra, Geonoma triglochin, Geonoma trigona, Geonoma undata, Geonoma venosa, Hyospathe elegans, Hyospathe macrorhachis, Iriartea deltoidea, Itaya amicorum, Manicaria saccifera, Mauritia flexuosa, Mauritiella armata, Mauritiella macroclada, Oenocarpus bataua, Oenocarpus mapora, Parajubaea cocoides, Pholidostachys dactyloides, Pholidostachys occidentalis, Pholidostachys synanthera, Phytelephas aequatorialis, Phytelephas tenuicaulis, Prestoea acuminata, Prestoea carderi, Prestoea decurrens, Prestoea ensiformis, Prestoea schultzeana, Socratea exorrhiza, Socratea hecatonandra, Socratea rostrata, Syagrus sancona, Syagrus smithii, Synechanthus warscewiczianus, Welfia regia, Wendlandiella gracilis, Wettinia aequalis, Wettinia aequatorialis, Wettinia anomala, Wettinia drudei, Wettinia fascicularis, Wettinia kalbreyeri, Wettinia maynensis, Wettinia minima, Wettinia oxycarpa, Wettinia quinaria, Wettinia verruculosa"
"EGY"	"Hyphaene thebaica, Medemia argun, Phoenix dactylifera"
"EHM"	"Areca catechu, Arenga micrantha, Arenga westerhoutii, Calamus acanthospathus, Calamus erectus, Calamus flagellum, Calamus floribundus, Calamus gracilis, Calamus guruba, Calamus inermis, Calamus jenkinsianus, Calamus latifolius, Calamus leptospadix, Calamus tenuis, Calamus viminalis, Caryota maxima, Caryota obtusa, Licuala peltata, Livistona jenkinsiana, Phoenix loureiroi, Phoenix rupicola, Pinanga gracilis, Plectocomia assamica, Plectocomia himalayana, Salacca secunda, Trachycarpus latisectus, Trachycarpus martianus, Wallichia disticha, Wallichia nana, Wallichia oblongifolia, Wallichia triandra"
"ELS"	"Acrocomia aculeata, Astrocaryum mexicanum, Attalea cohune, Bactris gasipaes, Bactris major, Brahea dulcis, Brahea salvadorensis, Chamaedorea costaricana, Chamaedorea nubium, Chamaedorea pinnatifrons, Chamaedorea tepejilote, Cocos nucifera, Desmoncus chinantlensis, Dypsis lutescens, Elaeis guineensis, Phoenix dactylifera, Roystonea regia, Sabal mexicana"
"EQG"	"Calamus deerratus, Eremospatha cuspidata, Eremospatha hookeri, Eremospatha laurentii, Eremospatha macrocarpa, Eremospatha tessmanniana, Eremospatha wendlandiana, Laccosperma acutiflorum, Laccosperma opacum, Laccosperma robustum, Oncocalamus macrospathus, Oncocalamus mannii, Podococcus barteri, Raphia hookeri, Raphia longiflora, Sclerosperma mannii"
"ERI"	"Hyphaene thebaica, Phoenix reclinata"
"ETH"	"Borassus aethiopum, Elaeis guineensis, Hyphaene compressa, Hyphaene coriacea, Hyphaene thebaica, Phoenix reclinata"
"FAL"	"NA"
"FIJ"	"Areca catechu, Balaka diffusa, Balaka longirostris, Balaka macrocarpa, Balaka microcarpa, Balaka pauciflora, Balaka seemannii, Balaka streptostachys, Calamus vitiensis, Clinostigma exorrhizum, Cocos nucifera, Cyphosperma naboutinense, Cyphosperma tanga, Cyphosperma trichospadix, Elaeis guineensis, Heterospathe longipes, Heterospathe phillipsii, Hydriastele boumae, Hydriastele vitiensis, Metroxylon vitiense, Metroxylon warburgii, Neoveitchia storckii, Phoenix dactylifera, Physokentia petiolata, Physokentia thurstonii, Pinanga coronata, Pritchardia pacifica, Pritchardia thurstonii, Ptychosperma macarthurii, Veitchia filifera, Veitchia joannis, Veitchia simulans, Veitchia vitiensis"
"FIN"	"NA"
"FLA"	"Acoelorrhaphe wrightii, Chamaedorea seifrizii, Coccothrinax argentata, Cocos nucifera, Leucothrinax morrisii, Livistona chinensis, Phoenix reclinata, Pseudophoenix sargentii, Ptychosperma elegans, Rhapidophyllum hystrix, Roystonea regia, Sabal etonia, Sabal minor, Sabal palmetto, Serenoa repens, Syagrus romanzoffiana, Thrinax radiata, Washingtonia filifera, Washingtonia robusta"
"FOR"	"NA"
"FRA"	"Chamaerops humilis"
"FRG"	"Acrocomia aculeata, Asterogyne guianensis, Astrocaryum aculeatum, Astrocaryum jauari, Astrocaryum minus, Astrocaryum murumuru, Astrocaryum paramaca, Astrocaryum rodriguesii, Astrocaryum sciophilum, Astrocaryum tucuma, Astrocaryum vulgare, Attalea attaleoides, Attalea camopiensis, Attalea degranvillei, Attalea guianensis, Attalea maripa, Attalea maripensis, Attalea microcarpa, Bactris acanthocarpa, Bactris acanthocarpoides, Bactris aubletiana, Bactris brongniartii, Bactris campestris, Bactris constanciae, Bactris cuspidata, Bactris elegans, Bactris gasipaes, Bactris gastoniana, Bactris hirta, Bactris major, Bactris maraja, Bactris nancibaensis, Bactris oligocarpa, Bactris pliniana, Bactris rhaphidacantha, Bactris simplicifrons, Bactris tomentosa, Desmoncus horridus, Desmoncus parvulus, Desmoncus polyacanthos, Elaeis oleifera, Euterpe oleracea, Euterpe precatoria, Geonoma baculifera, Geonoma deversa, Geonoma euspatha, Geonoma leptospadix, Geonoma maxima, Geonoma oldemanii, Geonoma poiteauana, Geonoma stricta, Geonoma umbraculiformis, Geonoma undata, Hyospathe elegans, Manicaria saccifera, Mauritia flexuosa, Oenocarpus bacaba, Oenocarpus bataua, Socratea exorrhiza, Syagrus inajai, Syagrus stratincola"
"GAB"	"Calamus deerratus, Cocos nucifera, Elaeis guineensis, Eremospatha cabrae, Eremospatha cuspidata, Eremospatha haullevilleana, Eremospatha hookeri, Eremospatha laurentii, Eremospatha wendlandiana, Hyphaene guineensis, Laccosperma acutiflorum, Laccosperma cristalensis, Laccosperma laeve, Laccosperma opacum, Laccosperma robustum, Laccosperma secundiflorum, Oncocalamus macrospathus, Oncocalamus mannii, Phoenix reclinata, Podococcus acaulis, Podococcus barteri, Raphia hookeri, Raphia longiflora, Raphia regalis, Raphia textilis, Raphia vinifera, Sclerosperma mannii, Sclerosperma walkeri"
"GAL"	"NA"
"GAM"	"Borassus aethiopum, Calamus deerratus, Cocos nucifera, Elaeis guineensis, Hyphaene thebaica, Phoenix dactylifera, Phoenix reclinata, Raphia farinifera, Raphia hookeri, Raphia palma-pinus, Raphia sudanica, Raphia vinifera"
"GEO"	"Cocos nucifera, Rhapidophyllum hystrix, Sabal palmetto, Serenoa repens"
"GER"	"NA"
"GGI"	"Borassus aethiopum, Cocos nucifera, Elaeis guineensis, Laccosperma opacum, Laccosperma secundiflorum, Phoenix dactylifera, Raphia hookeri, Raphia mannii, Raphia vinifera, Sclerosperma mannii"
"GHA"	"Borassus aethiopum, Calamus deerratus, Cocos nucifera, Elaeis guineensis, Eremospatha dransfieldii, Eremospatha macrocarpa, Hyphaene guineensis, Hyphaene thebaica, Laccosperma acutiflorum, Laccosperma laeve, Laccosperma opacum, Laccosperma secundiflorum, Phoenix reclinata, Raphia farinifera, Raphia hookeri, Raphia palma-pinus, Raphia sudanica, Raphia vinifera, Sclerosperma profizianum"
"GIL"	"Cocos nucifera"
"GNB"	"Borassus aethiopum, Borassus akeassii, Calamus deerratus, Cocos nucifera, Elaeis guineensis, Hyphaene guineensis, Hyphaene thebaica, Laccosperma secundiflorum, Phoenix reclinata, Raphia palma-pinus"
"GNL"	"NA"
"GRB"	"NA"
"GRC"	"Phoenix canariensis, Phoenix theophrasti"
"GST"	"Nannorrhops ritchieana, Phoenix dactylifera"
"GUA"	"Acoelorrhaphe wrightii, Acrocomia aculeata, Asterogyne martiana, Astrocaryum mexicanum, Attalea cohune, Attalea rostrata, Bactris major, Bactris mexicana, Brahea calcarea, Brahea dulcis, Calyptrogyne ghiesbreghtiana, Chamaedorea adscendens, Chamaedorea arenbergiana, Chamaedorea brachypoda, Chamaedorea carchensis, Chamaedorea castillo-montii, Chamaedorea costaricana, Chamaedorea elatior, Chamaedorea elegans, Chamaedorea ernesti-augusti, Chamaedorea falcifera, Chamaedorea fractiflexa, Chamaedorea geonomiformis, Chamaedorea ibarrae, Chamaedorea keelerorum, Chamaedorea lehmannii, Chamaedorea liebmannii, Chamaedorea nationsiana, Chamaedorea neurochlamys, Chamaedorea nubium, Chamaedorea oblongata, Chamaedorea pachecoana, Chamaedorea parvisecta, Chamaedorea pinnatifrons, Chamaedorea rojasiana, Chamaedorea schippii, Chamaedorea seifrizii, Chamaedorea simplex, Chamaedorea skutchii, Chamaedorea stenocarpa, Chamaedorea stricta, Chamaedorea tenerrima, Chamaedorea tepejilote, Chamaedorea tuerckheimii, Chamaedorea verapazensis, Chamaedorea volcanensis, Chamaedorea vulgata, Chamaedorea woodsoniana, Colpothrinax cookii, Cryosophila stauracantha, Desmoncus chinantlensis, Euterpe precatoria, Gaussia maya, Geonoma deversa, Geonoma interrupta, Geonoma pinnatifrons, Geonoma undata, Manicaria saccifera, Reinhardtia gracilis, Reinhardtia latisecta, Sabal mauritiiformis, Sabal mexicana, Schippia concolor, Synechanthus fibrosus"
"GUI"	"Borassus aethiopum, Calamus deerratus, Cocos nucifera, Elaeis guineensis, Eremospatha macrocarpa, Laccosperma opacum, Laccosperma secundiflorum, Phoenix reclinata, Raphia farinifera, Raphia hookeri, Raphia palma-pinus, Raphia sudanica"
"GUY"	"Acrocomia aculeata, Astrocaryum acaule, Astrocaryum aculeatum, Astrocaryum farinosum, Astrocaryum jauari, Astrocaryum murumuru, Astrocaryum sciophilum, Astrocaryum tucuma, Astrocaryum vulgare, Attalea attaleoides, Attalea maripa, Attalea microcarpa, Attalea speciosa, Bactris acanthocarpa, Bactris acanthocarpoides, Bactris brongniartii, Bactris campestris, Bactris elegans, Bactris hirta, Bactris major, Bactris maraja, Bactris oligoclada, Bactris pliniana, Bactris ptariana, Bactris simplicifrons, Desmoncus horridus, Desmoncus parvulus, Desmoncus polyacanthos, Dictyocaryum ptarianum, Euterpe catinga, Euterpe longibracteata, Euterpe oleracea, Euterpe precatoria, Geonoma aspidiifolia, Geonoma baculifera, Geonoma deversa, Geonoma euspatha, Geonoma leptospadix, Geonoma maxima, Geonoma poiteauana, Geonoma stricta, Geonoma umbraculiformis, Geonoma undata, Hyospathe elegans, Iriartella setigera, Lepidocaryum tenue, Manicaria saccifera, Mauritia flexuosa, Mauritiella armata, Nypa fruticans, Oenocarpus bacaba, Oenocarpus bataua, Prestoea tenuiramosa, Roystonea oleracea, Socratea exorrhiza, Syagrus cocoides, Syagrus inajai, Syagrus stratincola"
"HAI"	"Acrocomia aculeata, Adonidia merrillii, Areca catechu, Attalea crassispatha, Bactris plumeriana, Calyptronoma plumeriana, Calyptronoma rivalis, Caryota mitis, Caryota urens, Coccothrinax argentea, Coccothrinax concolor, Coccothrinax fragrans, Coccothrinax gracilis, Coccothrinax jimenezii, Coccothrinax montana, Coccothrinax scoparia, Coccothrinax spissa, Cocos nucifera, Copernicia berteroana, Copernicia ekmanii, Dypsis lutescens, Elaeis guineensis, Leucothrinax morrisii, Prestoea acuminata, Pseudophoenix lediniana, Pseudophoenix sargentii, Pseudophoenix vinifera, Roystonea borinquena, Roystonea regia, Sabal causiarum, Sabal domingensis, Thrinax radiata, Zombia antillarum"
"HAW"	"Archontophoenix alexandrae, Arenga pinnata, Chamaedorea cataractarum, Coccothrinax barbadensis, Cocos nucifera, Licuala spinosa, Livistona chinensis, Pinanga coronata, Pritchardia arecina, Pritchardia bakeri, Pritchardia beccariana, Pritchardia flynnii, Pritchardia forbesiana, Pritchardia glabrata, Pritchardia gordonii, Pritchardia hardyi, Pritchardia hillebrandii, Pritchardia kaalae, Pritchardia kahukuensis, Pritchardia lanigera, Pritchardia lowreyana, Pritchardia maideniana, Pritchardia martii, Pritchardia minor, Pritchardia munroi, Pritchardia napaliensis, Pritchardia perlmanii, Pritchardia remota, Pritchardia schattaueri, Pritchardia viscosa, Pritchardia waialealeana, Pritchardia woodii, Washingtonia filifera, Washingtonia robusta"
"HBI"	"NA"
"HMD"	"NA"
"HON"	"Acoelorrhaphe wrightii, Acrocomia aculeata, Asterogyne martiana, Astrocaryum alatum, Astrocaryum mexicanum, Attalea cohune, Attalea rostrata, Bactris gasipaes, Bactris major, Bactris mexicana, Bactris obovata, Brahea dulcis, Brahea salvadorensis, Calyptrogyne ghiesbreghtiana, Chamaedorea arenbergiana, Chamaedorea brachypoda, Chamaedorea castillo-montii, Chamaedorea costaricana, Chamaedorea elatior, Chamaedorea elegans, Chamaedorea ernesti-augusti, Chamaedorea frondosa, Chamaedorea geonomiformis, Chamaedorea moliniana, Chamaedorea neurochlamys, Chamaedorea nubium, Chamaedorea oblongata, Chamaedorea pinnatifrons, Chamaedorea sartorii, Chamaedorea schippii, Chamaedorea seifrizii, Chamaedorea tepejilote, Chamaedorea tuerckheimii, Chamaedorea woodsoniana, Cocos nucifera, Colpothrinax cookii, Cryosophila stauracantha, Cryosophila warscewiczii, Cryosophila williamsii, Desmoncus chinantlensis, Elaeis oleifera, Euterpe precatoria, Geonoma congesta, Geonoma deversa, Geonoma interrupta, Geonoma pinnatifrons, Geonoma undata, Manicaria saccifera, Neonicholsonia watsonii, Reinhardtia elegans, Reinhardtia gracilis, Reinhardtia koschnyana, Reinhardtia latisecta, Reinhardtia simplex, Roystonea dunlapiana, Roystonea regia, Sabal mauritiiformis, Sabal mexicana, Syagrus romanzoffiana, Synechanthus fibrosus, Thrinax radiata, Welfia regia"
"HUN"	"NA"
"ICE"	"NA"
"IDA"	"NA"
"ILL"	"NA"
"IND"	"Areca catechu, Arenga pinnata, Arenga wightii, Bentinckia condapanna, Borassus flabellifer, Calamus brandisii, Calamus gamblei, Calamus gracilis, Calamus guruba, Calamus hookerianus, Calamus karnatakensis, Calamus lakshmanae, Calamus metzianus, Calamus nagbettai, Calamus rheedei, Calamus rotang, Calamus stolonifer, Calamus tenuis, Calamus thwaitesii, Calamus vattayila, Calamus viminalis, Calamus wightii, Caryota urens, Cocos nucifera, Corypha taliera, Corypha umbraculifera, Hyphaene dichotoma, Licuala peltata, Nypa fruticans, Phoenix acaulis, Phoenix dactylifera, Phoenix loureiroi, Phoenix paludosa, Phoenix pusilla, Phoenix sylvestris, Pinanga dicksonii"
"INI"	"NA"
"IOW"	"NA"
"IRE"	"NA"
"IRK"	"NA"
"IRN"	"Nannorrhops baluchestanica, Nannorrhops ritchieana, Phoenix dactylifera"
"IRQ"	"Phoenix dactylifera"
"ITA"	"Chamaerops humilis, Phoenix canariensis, Trachycarpus fortunei, Washingtonia filifera, Washingtonia robusta"
"IVO"	"Borassus aethiopum, Borassus akeassii, Calamus deerratus, Cocos nucifera, Elaeis guineensis, Eremospatha dransfieldii, Eremospatha macrocarpa, Hyphaene thebaica, Laccosperma acutiflorum, Laccosperma laeve, Laccosperma opacum, Laccosperma secundiflorum, Phoenix reclinata, Raphia farinifera, Raphia hookeri, Raphia palma-pinus, Raphia sudanica"
"JAM"	"Acrocomia aculeata, Areca catechu, Bactris jamaicana, Calyptronoma occidentalis, Coccothrinax jamaicensis, Cocos nucifera, Dypsis lutescens, Roystonea altissima, Roystonea princeps, Sabal maritima, Thrinax excelsa, Thrinax parviflora"
"JAP"	"Arenga ryukyuensis, Livistona chinensis, Rhapis excelsa, Rhapis humilis, Trachycarpus fortunei"
"JAW"	"Areca catechu, Areca montana, Arenga obtusifolia, Arenga porphyrocarpa, Borassus flabellifer, Calamus adspersus, Calamus asperrimus, Calamus burckianus, Calamus ciliaris, Calamus glaucescens, Calamus heteroideus, Calamus javensis, Calamus melanochaetes, Calamus melanoloma, Calamus oblongus, Calamus occidentalis, Calamus ornatus, Calamus parutan, Calamus polystachys, Calamus pseudoconcolor, Calamus reinwardtii, Calamus rhomboideus, Calamus ruber, Calamus sedisspirituum, Calamus tenuis, Calamus unifarius, Calamus viminalis, Caryota maxima, Caryota mitis, Cocos nucifera, Corypha utan, Korthalsia junghuhnii, Korthalsia laciniosa, Lanonia gracilis, Licuala pumila, Licuala spectabilis, Licuala spinosa, Livistona chinensis, Livistona saribus, Metroxylon sagu, Nenga pumila, Nypa fruticans, Oncosperma tigillarium, Orania sylvicola, Pinanga coronata, Pinanga javana, Plectocomia elongata, Plectocomia longistigma, Rhapis humilis, Salacca zalacca, Saribus rotundifolius"
"JNF"	"Juania australis"
"KAM"	"NA"
"KAN"	"NA"
"KAZ"	"NA"
"KEG"	"NA"
"KEN"	"Borassus aethiopum, Cocos nucifera, Elaeis guineensis, Hyphaene compressa, Hyphaene coriacea, Hyphaene reptans, Phoenix reclinata, Raphia farinifera"
"KER"	"Rhopalostylis baueri"
"KGZ"	"NA"
"KHA"	"NA"
"KOR"	"NA"
"KRA"	"NA"
"KRI"	"Phoenix theophrasti, Washingtonia filifera"
"KRY"	"NA"
"KTY"	"NA"
"KUR"	"NA"
"KUW"	"NA"
"KZN"	"Livistona boninensis"
"LAB"	"NA"
"LAO"	"Areca catechu, Areca laosensis, Areca triandra, Arenga caudata, Arenga westerhoutii, Borassus flabellifer, Calamus acanthophyllus, Calamus acanthospathus, Calamus bimanifer, Calamus erectus, Calamus evansii, Calamus flagellum, Calamus godefroyi, Calamus gracilis, Calamus harmandii, Calamus henryanus, Calamus inermis, Calamus jenkinsianus, Calamus laoensis, Calamus latifolius, Calamus minor, Calamus nitidus, Calamus oligostachys, Calamus poilanei, Calamus rhabdocladus, Calamus rudentum, Calamus tenuis, Calamus tetradactylus, Calamus viminalis, Caryota maxima, Caryota mitis, Caryota obtusa, Caryota sympetala, Corypha lecomtei, Corypha utan, Korthalsia laciniosa, Korthalsia minor, Lanonia centralis, Livistona saribus, Myrialepis paradoxa, Phoenix loureiroi, Phoenix roebelenii, Pinanga sylvestris, Plectocomia himalayana, Plectocomia pierreana, Plectocomiopsis geminiflora, Rhapis evansii, Rhapis laosensis, Rhapis subtilis, Salacca wallichiana, Trachycarpus ravenii, Wallichia disticha"
"LBR"	"Calamus deerratus, Cocos nucifera, Elaeis guineensis, Eremospatha hookeri, Eremospatha laurentii, Eremospatha macrocarpa, Hyphaene guineensis, Laccosperma acutiflorum, Laccosperma laeve, Laccosperma opacum, Laccosperma secundiflorum, Phoenix reclinata, Raphia hookeri, Raphia palma-pinus, Sclerosperma mannii"
"LBS"	"NA"
"LBY"	"Chamaerops humilis, Hyphaene thebaica, Phoenix dactylifera"
"LDV"	"Cocos nucifera"
"LEE"	"Acrocomia aculeata, Acrocomia media, Adonidia merrillii, Areca catechu, Coccothrinax alta, Coccothrinax barbadensis, Cocos nucifera, Dypsis lutescens, Geonoma pinnatifrons, Geonoma undata, Leucothrinax morrisii, Phoenix dactylifera, Phoenix reclinata, Phoenix rupicola, Phoenix sylvestris, Prestoea acuminata, Roystonea borinquena, Roystonea oleracea, Roystonea regia, Sabal bermudana, Sabal causiarum, Syagrus amara"
"LES"	"NA"
"LIN"	"Cocos nucifera"
"LOU"	"Sabal minor, Serenoa repens"
"LSI"	"Areca catechu, Arenga pinnata, Borassus flabellifer, Calamus adspersus, Calamus melanochaetes, Calamus parutan, Calamus sumbawensis, Calamus timorensis, Calamus unifarius, Calamus viminalis, Caryota mitis, Cocos nucifera, Corypha utan, Nypa fruticans, Pinanga arinasae, Pinanga coronata, Salacca zalacca, Saribus rotundifolius"
"MAG"	"NA"
"MAI"	"NA"
"MAN"	"NA"
"MAQ"	"NA"
"MAS"	"NA"
"MAU"	"Acanthophoenix rubra, Cocos nucifera, Dictyosperma album, Dypsis madagascariensis, Hyophorbe lagenicaulis, Hyophorbe vaughanii, Latania loddigesii, Livistona chinensis, Phoenix dactylifera, Phoenix sylvestris, Raphia farinifera, Roystonea oleracea, Syagrus romanzoffiana, Tectiphiala ferox"
"MCI"	"Cocos nucifera, Hyphaene coriacea, Phoenix dactylifera"
"MCS"	"Cocos nucifera"
"MDG"	"Beccariophoenix alfredii, Beccariophoenix fenestralis, Beccariophoenix madagascariensis, Bismarckia nobilis, Borassus aethiopum, Borassus madagascariensis, Cocos nucifera, Dypsis acaulis, Dypsis acuminum, Dypsis albofarinosa, Dypsis ambanjae, Dypsis ambilaensis, Dypsis ambositrae, Dypsis andapae, Dypsis andilamenensis, Dypsis andrianatonga, Dypsis angusta, Dypsis angustifolia, Dypsis anjae, Dypsis ankaizinensis, Dypsis ankirindro, Dypsis antanambensis, Dypsis aquatilis, Dypsis arenarum, Dypsis baronii, Dypsis basilonga, Dypsis beentjei, Dypsis bejofo, Dypsis bernieriana, Dypsis betamponensis, Dypsis betsimisarakae, Dypsis boiviniana, Dypsis bonsai, Dypsis bosseri, Dypsis brevicaulis, Dypsis brittiana, Dypsis canaliculata, Dypsis carlsmithii, Dypsis catatiana, Dypsis caudata, Dypsis ceracea, Dypsis commersoniana, Dypsis concinna, Dypsis confusa, Dypsis cookei, Dypsis coriacea, Dypsis corniculata, Dypsis coursii, Dypsis crinita, Dypsis culminis, Dypsis curtisii, Dypsis decaryi, Dypsis decipiens, Dypsis delicatula, Dypsis digitata, Dypsis dracaenoides, Dypsis dransfieldii, Dypsis elegans, Dypsis eriostachys, Dypsis faneva, Dypsis fanjana, Dypsis fasciculata, Dypsis fibrosa, Dypsis forficifolia, Dypsis furcata, Dypsis gautieri, Dypsis glabrescens, Dypsis gronophyllum, Dypsis henrici, Dypsis heteromorpha, Dypsis heterophylla, Dypsis hiarakae, Dypsis hildebrandtii, Dypsis hovomantsina, Dypsis humbertii, Dypsis humilis, Dypsis ifanadianae, Dypsis integra, Dypsis intermedia, Dypsis interrupta, Dypsis jeremiei, Dypsis jumelleana, Dypsis laevis, Dypsis lantzeana, Dypsis lanuginosa, Dypsis lastelliana, Dypsis leptocheilos, Dypsis leucomalla, Dypsis lilacina, Dypsis linearis, Dypsis lokohoensis, Dypsis louvelii, Dypsis lutea, Dypsis lutescens, Dypsis madagascariensis, Dypsis mahia, Dypsis makirae, Dypsis malcomberi, Dypsis mananjarensis, Dypsis mangorensis, Dypsis marojejyi, Dypsis mcdonaldiana, Dypsis metallica, Dypsis minuta, Dypsis mirabilis, Dypsis mocquerysiana, Dypsis montana, Dypsis moorei, Dypsis nauseosa, Dypsis nodifera, Dypsis nossibensis, Dypsis occidentalis, Dypsis onilahensis, Dypsis oreophila, Dypsis oropedionis, Dypsis ovobontsira, Dypsis pachyramea, Dypsis paludosa, Dypsis perrieri, Dypsis pervillei, Dypsis pilulifera, Dypsis pinnatifrons, Dypsis plumosa, Dypsis poivreana, Dypsis prestoniana, Dypsis procera, Dypsis procumbens, Dypsis psammophila, Dypsis pulchella, Dypsis pumila, Dypsis pusilla, Dypsis pustulata, Dypsis rakotonasoloi, Dypsis ramentacea, Dypsis reflexa, Dypsis remotiflora, Dypsis rivularis, Dypsis robusta, Dypsis rosea, Dypsis sahanofensis, Dypsis saintelucei, Dypsis sancta, Dypsis sanctaemariae, Dypsis scandens, Dypsis schatzii, Dypsis scottiana, Dypsis serpentina, Dypsis simianensis, Dypsis singularis, Dypsis soanieranae, Dypsis spicata, Dypsis subacaulis, Dypsis tanalensis, Dypsis tenuissima, Dypsis thermarum, Dypsis thiryana, Dypsis thouarsiana, Dypsis tokoravina, Dypsis trapezoidea, Dypsis tsaratananensis, Dypsis tsaravoasira, Dypsis turkii, Dypsis utilis, Dypsis viridis, Dypsis vonitrandambo, Elaeis guineensis, Hyphaene coriacea, Lemurophoenix halleuxii, Marojejya darianii, Marojejya insignis, Masoala kona, Masoala madagascariensis, Orania longisquama, Orania ravaka, Orania trispatha, Phoenix reclinata, Raphia farinifera, Ravenea albicans, Ravenea beentjei, Ravenea declivium, Ravenea delicatula, Ravenea dransfieldii, Ravenea glauca, Ravenea hypoleuca, Ravenea julietiae, Ravenea krociana, Ravenea lakatra, Ravenea latisecta, Ravenea louvelii, Ravenea madagascariensis, Ravenea musicalis, Ravenea nana, Ravenea rivularis, Ravenea robustior, Ravenea sambiranensis, Ravenea xerophila, Satranala decussilvae, Tahina spectabilis, Voanioala gerardii"
"MDR"	"Phoenix dactylifera, Washingtonia filifera"
"MDV"	"Areca catechu, Cocos nucifera"
"MIC"	"NA"
"MIN"	"NA"
"MLI"	"Borassus aethiopum, Borassus akeassii, Hyphaene thebaica, Phoenix dactylifera, Raphia sudanica"
"MLW"	"Borassus aethiopum, Elaeis guineensis, Hyphaene petersiana, Phoenix reclinata, Raphia farinifera"
"MLY"	"Actinorhytis calapparia, Areca catechu, Areca montana, Areca ridleyana, Areca triandra, Areca tunku, Arenga caudata, Arenga hastata, Arenga hookeriana, Arenga obtusifolia, Arenga pinnata, Arenga westerhoutii, Borassodendron machadonis, Borassus flabellifer, Calamus angustifolius, Calamus axillaris, Calamus balingensis, Calamus brachypodus, Calamus burkillianus, Calamus caesius, Calamus calicarpus, Calamus calospathus, Calamus castaneus, Calamus cockburnii, Calamus concinnus, Calamus conirostris, Calamus corneri, Calamus densiflorus, Calamus didymophyllus, Calamus diepenhorstii, Calamus draco, Calamus erinaceus, Calamus erioacanthus, Calamus exilis, Calamus filipendulus, Calamus flabellatus, Calamus geniculatus, Calamus georgei, Calamus grandis, Calamus griseus, Calamus helferianus, Calamus hirsutus, Calamus holttumii, Calamus insignis, Calamus javensis, Calamus kunstleri, Calamus latifolius, Calamus laxissimus, Calamus leptopus, Calamus lewisianus, Calamus lobbianus, Calamus longipes, Calamus longisetus, Calamus longispatha, Calamus macrophyllus, Calamus manan, Calamus melanochaetes, Calamus micracanthus, Calamus micranthus, Calamus minutus, Calamus monticola, Calamus moorhousei, Calamus nitidus, Calamus oligophyllus, Calamus ornatus, Calamus oxleyanus, Calamus padangensis, Calamus pandanosmus, Calamus paspalanthus, Calamus penicillatus, Calamus perakensis, Calamus peregrinus, Calamus periacanthus, Calamus plicatus, Calamus polystachys, Calamus pycnocarpus, Calamus radulosus, Calamus rhomboideus, Calamus ridleyanus, Calamus rugosus, Calamus sabut, Calamus scabridulus, Calamus scapigerus, Calamus scipionum, Calamus sedens, Calamus senalingensis, Calamus sepal, Calamus simplex, Calamus spectatissimus, Calamus subangulatus, Calamus tanakadatei, Calamus tumidus, Calamus ursinus, Calamus verticillaris, Calamus viminalis, Calamus whitmorei, Caryota maxima, Caryota mitis, Caryota urens, Cocos nucifera, Corypha utan, Cyrtostachys renda, Elaeis guineensis, Eleiodoxa conferta, Eugeissona brachystachys, Eugeissona tristis, Iguanura asli, Iguanura belumensis, Iguanura bicornis, Iguanura cemurung, Iguanura corniculata, Iguanura diffusa, Iguanura geonomiformis, Iguanura humilis, Iguanura kelantanensis, Iguanura mirabilis, Iguanura parvula, Iguanura perdana, Iguanura piahensis, Iguanura polymorpha, Iguanura speciosa, Iguanura wallichiana, Johannesteijsmannia altifrons, Johannesteijsmannia lanceolata, Johannesteijsmannia magnifica, Johannesteijsmannia perakensis, Korthalsia echinometra, Korthalsia flagellaris, Korthalsia hispida, Korthalsia laciniosa, Korthalsia lanceolata, Korthalsia rigida, Korthalsia rostrata, Korthalsia scortechinii, Korthalsia tenuissima, Licuala acutifida, Licuala ahlidurii, Licuala bayana, Licuala cameronensis, Licuala corneri, Licuala egregia, Licuala ferruginea, Licuala fractiflexa, Licuala glabra, Licuala grandis, Licuala kamarudinii, Licuala kemamanensis, Licuala khoonmengii, Licuala kiahii, Licuala kingiana, Licuala kunstleri, Licuala lanuginosa, Licuala longicalycata, Licuala longipes, Licuala malajana, Licuala mirabilis, Licuala modesta, Licuala moyseyi, Licuala mustapana, Licuala pahangensis, Licuala palas, Licuala paludosa, Licuala patens, Licuala peltata, Licuala pusilla, Licuala ridleyana, Licuala ruthiae, Licuala sallehana, Licuala scortechinii, Licuala spinosa, Licuala stongensis, Licuala tenuissima, Licuala terengganuensis, Licuala thoana, Licuala tiomanensis, Licuala triphylla, Licuala whitmorei, Livistona endauensis, Livistona saribus, Livistona speciosa, Livistona tahanensis, Maxburretia gracilis, Maxburretia rupicola, Metroxylon sagu, Myrialepis paradoxa, Nenga grandiflora, Nenga macrocarpa, Nenga pumila, Nypa fruticans, Oncosperma horridum, Oncosperma tigillarium, Orania sylvicola, Phoenix paludosa, Pholidocarpus kingianus, Pholidocarpus macrocarpus, Pinanga acaulis, Pinanga adangensis, Pinanga auriculata, Pinanga badia, Pinanga brewsteriana, Pinanga cleistantha, Pinanga disticha, Pinanga glaucescens, Pinanga jamariensis, Pinanga johorensis, Pinanga limosa, Pinanga malaiana, Pinanga palustris, Pinanga pantiensis, Pinanga paradoxa, Pinanga pectinata, Pinanga perakensis, Pinanga polymorpha, Pinanga riparia, Pinanga sarmentosa, Pinanga scortechinii, Pinanga sembilan, Pinanga simplicifrons, Pinanga singaporensis, Pinanga subintegra, Pinanga subruminata, Plectocomia dransfieldiana, Plectocomia elongata, Plectocomia mulleri, Plectocomiopsis corneri, Plectocomiopsis geminiflora, Plectocomiopsis mira, Plectocomiopsis wrayi, Rhopaloblaste singaporensis, Salacca affinis, Salacca flabellata, Salacca glabrescens, Salacca graciliflora, Salacca minuta, Salacca multiflora, Salacca wallichiana, Salacca zalacca, Saribus rotundifolius"
"MNT"	"NA"
"MOL"	"Areca catechu, Areca macrocalyx, Areca vestiaria, Arenga microcarpa, Arenga pinnata, Calamus albus, Calamus aruensis, Calamus beguinii, Calamus calapparius, Calamus cawa, Calamus equestris, Calamus halmaherensis, Calamus heteracanthus, Calamus niger, Calamus robinsonianus, Calamus rumphii, Calamus symphysipus, Calamus usitatus, Calamus validus, Calamus vitiensis, Calamus warburgii, Calamus zollingeri, Calyptrocalyx spicatus, Caryota rumphiana, Cocos nucifera, Corypha utan, Drymophloeus litigiosus, Drymophloeus oliviformis, Heterospathe elata, Heterospathe glauca, Hydriastele beguinii, Hydriastele microcarpa, Hydriastele moluccana, Hydriastele oxypetala, Jailoloa halmaherensis, Korthalsia celebica, Licuala adscendens, Licuala flexuosa, Licuala rumphii, Metroxylon sagu, Nypa fruticans, Orania palindan, Pholidocarpus ihur, Pigafetta filaris, Pinanga globulifera, Pinanga rumphiana, Ptychosperma propinquum, Rhopaloblaste ceramica, Salacca zalacca, Saribus rotundifolius"
"MON"	"NA"
"MOR"	"Chamaerops humilis, Phoenix dactylifera"
"MOZ"	"Borassus aethiopum, Cocos nucifera, Elaeis guineensis, Hyphaene compressa, Hyphaene coriacea, Hyphaene petersiana, Phoenix reclinata, Raphia australis, Raphia farinifera"
"MPE"	"NA"
"MRN"	"Areca catechu, Cocos nucifera, Heterospathe elata, Livistona chinensis, Metroxylon amicarum, Nypa fruticans"
"MRQ"	"Cocos nucifera, Pelagodoxa henryana, Pritchardia pacifica"
"MRS"	"Cocos nucifera, Pritchardia pacifica"
"MRY"	"NA"
"MSI"	"Rhapidophyllum hystrix, Sabal minor, Serenoa repens"
"MSO"	"NA"
"MTN"	"Borassus flabellifer, Hyphaene thebaica, Phoenix dactylifera, Raphia sudanica"
"MXC"	"Brahea calcarea, Brahea dulcis, Chamaedorea elatior, Chamaedorea elegans, Chamaedorea liebmannii, Chamaedorea oblongata, Chamaedorea sartorii, Chamaedorea schiedeana, Sabal pumos"
"MXE"	"Brahea aculeata, Brahea decumbens, Brahea dulcis, Brahea moorei, Chamaedorea elegans, Chamaedorea microspadix, Chamaedorea oblongata, Chamaedorea radicalis, Sabal mexicana, Sabal minor, Sabal pumos, Sabal uresana, Washingtonia filifera, Washingtonia robusta"
"MXG"	"Acoelorrhaphe wrightii, Acrocomia aculeata, Astrocaryum mexicanum, Attalea rostrata, Bactris major, Bactris mexicana, Brahea dulcis, Calyptrogyne ghiesbreghtiana, Chamaedorea alternans, Chamaedorea arenbergiana, Chamaedorea elatior, Chamaedorea elegans, Chamaedorea ernesti-augusti, Chamaedorea geonomiformis, Chamaedorea hooperiana, Chamaedorea klotzschiana, Chamaedorea liebmannii, Chamaedorea metallica, Chamaedorea microspadix, Chamaedorea oblongata, Chamaedorea oreophila, Chamaedorea pinnatifrons, Chamaedorea sartorii, Chamaedorea schiedeana, Chamaedorea tepejilote, Chamaedorea tuerckheimii, Chamaedorea woodsoniana, Desmoncus chinantlensis, Gaussia gomez-pompae, Geonoma interrupta, Reinhardtia gracilis, Roystonea regia, Sabal mauritiiformis, Sabal mexicana, Synechanthus fibrosus"
"MXI"	"Brahea edulis"
"MXN"	"Brahea aculeata, Brahea armata, Brahea brandegeei, Brahea calcarea, Brahea dulcis, Chamaedorea pochutlensis, Cryosophila nana, Phoenix dactylifera, Sabal rosei, Sabal uresana, Washingtonia filifera, Washingtonia robusta"
"MXS"	"Acrocomia aculeata, Astrocaryum mexicanum, Attalea cohune, Attalea guacuyule, Attalea rostrata, Bactris major, Bactris mexicana, Brahea calcarea, Brahea dulcis, Brahea pimo, Brahea sarukhanii, Chamaedorea arenbergiana, Chamaedorea atrovirens, Chamaedorea cataractarum, Chamaedorea elatior, Chamaedorea elegans, Chamaedorea ernesti-augusti, Chamaedorea foveata, Chamaedorea geonomiformis, Chamaedorea liebmannii, Chamaedorea metallica, Chamaedorea nubium, Chamaedorea oblongata, Chamaedorea oreophila, Chamaedorea pinnatifrons, Chamaedorea pochutlensis, Chamaedorea pygmaea, Chamaedorea queroana, Chamaedorea rhizomatosa, Chamaedorea rigida, Chamaedorea rojasiana, Chamaedorea sartorii, Chamaedorea schiedeana, Chamaedorea tepejilote, Chamaedorea tuerckheimii, Chamaedorea whitelockiana, Chamaedorea woodsoniana, Cocos nucifera, Cryosophila nana, Desmoncus chinantlensis, Gaussia gomez-pompae, Geonoma interrupta, Geonoma pinnatifrons, Reinhardtia elegans, Reinhardtia gracilis, Sabal mauritiiformis, Sabal mexicana, Sabal pumos, Sabal rosei, Synechanthus fibrosus"
"MXT"	"Acoelorrhaphe wrightii, Acrocomia aculeata, Astrocaryum mexicanum, Attalea cohune, Attalea rostrata, Bactris major, Bactris mexicana, Brahea calcarea, Calyptrogyne ghiesbreghtiana, Chamaedorea arenbergiana, Chamaedorea benziei, Chamaedorea cataractarum, Chamaedorea costaricana, Chamaedorea elatior, Chamaedorea elegans, Chamaedorea ernesti-augusti, Chamaedorea foveata, Chamaedorea fractiflexa, Chamaedorea geonomiformis, Chamaedorea glaucifolia, Chamaedorea ibarrae, Chamaedorea keelerorum, Chamaedorea liebmannii, Chamaedorea neurochlamys, Chamaedorea nubium, Chamaedorea oblongata, Chamaedorea parvisecta, Chamaedorea pinnatifrons, Chamaedorea plumosa, Chamaedorea rojasiana, Chamaedorea schippii, Chamaedorea seifrizii, Chamaedorea simplex, Chamaedorea stolonifera, Chamaedorea stricta, Chamaedorea tepejilote, Chamaedorea vulgata, Chamaedorea whitelockiana, Chamaedorea woodsoniana, Coccothrinax readii, Cocos nucifera, Cryosophila nana, Cryosophila stauracantha, Desmoncus chinantlensis, Gaussia gomez-pompae, Gaussia maya, Geonoma interrupta, Geonoma pinnatifrons, Geonoma undata, Pseudophoenix sargentii, Reinhardtia elegans, Reinhardtia gracilis, Reinhardtia simplex, Roystonea dunlapiana, Roystonea regia, Sabal gretherae, Sabal mauritiiformis, Sabal mexicana, Sabal yapa, Synechanthus fibrosus, Thrinax radiata"
"MYA"	"Areca triandra, Arenga caudata, Arenga pinnata, Arenga westerhoutii, Borassodendron machadonis, Borassus flabellifer, Calamus acanthospathus, Calamus arborescens, Calamus concinnus, Calamus erectus, Calamus flagellum, Calamus floribundus, Calamus gracilis, Calamus helferianus, Calamus henryanus, Calamus hukaungensis, Calamus inermis, Calamus javensis, Calamus jenkinsianus, Calamus kingianus, Calamus kurzianus, Calamus latifolius, Calamus leptospadix, Calamus longisetus, Calamus melanacanthos, Calamus micranthus, Calamus myrianthus, Calamus nitidus, Calamus peregrinus, Calamus platyspathus, Calamus rudentum, Calamus tenuis, Calamus viminalis, Caryota maxima, Caryota mitis, Caryota obtusa, Caryota urens, Cocos nucifera, Corypha taliera, Corypha umbraculifera, Corypha utan, Korthalsia laciniosa, Licuala merguensis, Licuala peltata, Licuala spinosa, Livistona jenkinsiana, Livistona speciosa, Myrialepis paradoxa, Nypa fruticans, Phoenix loureiroi, Phoenix paludosa, Phoenix roebelenii, Phoenix sylvestris, Pinanga acuminata, Pinanga auriculata, Pinanga gracilis, Pinanga griffithii, Pinanga hexasticha, Pinanga hymenospatha, Pinanga lacei, Pinanga plicata, Pinanga simplicifrons, Pinanga sylvestris, Pinanga tomentosa, Pinanga versicolor, Plectocomia assamica, Plectocomia elongata, Plectocomia macrostachya, Plectocomiopsis geminiflora, Salacca griffithii, Salacca secunda, Salacca wallichiana, Trachycarpus fortunei, Trachycarpus martianus, Wallichia caryotoides, Wallichia disticha, Wallichia lidiae, Wallichia oblongifolia"
"NAM"	"Hyphaene petersiana, Phoenix reclinata"
"NAT"	"Hyphaene coriacea, Jubaeopsis caffra, Livistona chinensis, Phoenix reclinata, Raphia australis"
"NBR"	"NA"
"NCA"	"Cocos nucifera, Sabal minor, Sabal palmetto"
"NCB"	"Areca catechu, Areca triandra, Bentinckia nicobarica, Calamus andamanicus, Calamus dilaceratus, Calamus latifolius, Calamus longisetus, Calamus nicobaricus, Calamus unifarius, Calamus viminalis, Caryota mitis, Cocos nucifera, Elaeis guineensis, Korthalsia laciniosa, Licuala peltata, Licuala spinosa, Nypa fruticans, Phoenix paludosa, Pinanga manii, Rhopaloblaste augusta"
"NCS"	"NA"
"NDA"	"NA"
"NEB"	"NA"
"NEP"	"Calamus acanthospathus, Calamus erectus, Calamus latifolius, Calamus leptospadix, Caryota urens, Phoenix acaulis, Phoenix loureiroi, Phoenix sylvestris, Pinanga gracilis, Plectocomia himalayana, Trachycarpus martianus, Wallichia oblongifolia"
"NET"	"NA"
"NEV"	"Washingtonia filifera"
"NFK"	"Hedyscepe canterburyana, Howea belmoreana, Howea forsteriana, Lepidorrhachis mooreana, Phoenix canariensis, Rhopalostylis baueri"
"NFL"	"NA"
"NGA"	"Borassus aethiopum, Borassus akeassii, Calamus deerratus, Cocos nucifera, Elaeis guineensis, Eremospatha hookeri, Eremospatha laurentii, Eremospatha macrocarpa, Eremospatha quinquecostulata, Eremospatha wendlandiana, Hyphaene thebaica, Laccosperma acutiflorum, Laccosperma opacum, Laccosperma robustum, Laccosperma secundiflorum, Nypa fruticans, Oncocalamus tuleyi, Oncocalamus wrightianus, Phoenix reclinata, Podococcus barteri, Raphia africana, Raphia farinifera, Raphia hookeri, Raphia longiflora, Raphia mambillensis, Raphia mannii, Raphia monbuttorum, Raphia regalis, Raphia sudanica, Raphia taedigera, Raphia vinifera, Sclerosperma mannii"
"NGR"	"Borassus aethiopum, Borassus akeassii, Calamus deerratus, Hyphaene thebaica, Laccosperma secundiflorum, Raphia sudanica"
"NIC"	"Acoelorrhaphe wrightii, Acrocomia aculeata, Asterogyne martiana, Astrocaryum alatum, Astrocaryum mexicanum, Attalea cohune, Attalea rostrata, Bactris caudata, Bactris coloradonis, Bactris dianeura, Bactris gasipaes, Bactris gracilior, Bactris grayumii, Bactris guineensis, Bactris major, Bactris mexicana, Bactris obovata, Brahea salvadorensis, Calyptrogyne ghiesbreghtiana, Chamaedorea costaricana, Chamaedorea dammeriana, Chamaedorea deckeriana, Chamaedorea graminifolia, Chamaedorea lucidifrons, Chamaedorea neurochlamys, Chamaedorea oblongata, Chamaedorea pinnatifrons, Chamaedorea tepejilote, Chamaedorea woodsoniana, Cocos nucifera, Colpothrinax aphanopetala, Cryosophila warscewiczii, Desmoncus chinantlensis, Desmoncus moorei, Elaeis guineensis, Elaeis oleifera, Euterpe precatoria, Geonoma congesta, Geonoma cuneata, Geonoma deversa, Geonoma ferruginea, Geonoma interrupta, Geonoma longivaginata, Geonoma orbignyana, Geonoma pinnatifrons, Geonoma undata, Iriartea deltoidea, Manicaria saccifera, Neonicholsonia watsonii, Pholidostachys pulchra, Prestoea acuminata, Prestoea decurrens, Prestoea longepetiolata, Prestoea schultzeana, Raphia taedigera, Reinhardtia gracilis, Reinhardtia koschnyana, Reinhardtia latisecta, Reinhardtia simplex, Roystonea dunlapiana, Sabal mexicana, Socratea exorrhiza, Synechanthus fibrosus, Synechanthus warscewiczianus, Thrinax radiata, Welfia regia"
"NLA"	"Copernicia berteroana, Copernicia tectorum, Hyphaene thebaica"
"NNS"	"Arenga ryukyuensis, Livistona chinensis, Nypa fruticans, Rhapis excelsa, Satakentia liukiuensis"
"NOR"	"NA"
"NRU"	"Cocos nucifera"
"NSC"	"NA"
"NSW"	"Archontophoenix cunninghamiana, Calamus muelleri, Linospadix monostachyos, Livistona australis, Phoenix canariensis, Syagrus romanzoffiana, Washingtonia filifera"
"NTA"	"Arenga microcarpa, Carpentaria acuminata, Corypha utan, Hydriastele ramsayi, Hydriastele wendlandiana, Livistona benthamii, Livistona humilis, Livistona inermis, Livistona lorophylla, Livistona mariae, Livistona rigida, Livistona victoriae, Nypa fruticans, Phoenix dactylifera, Ptychosperma macarthurii"
"NUE"	"Cocos nucifera, Pritchardia pacifica"
"NUN"	"NA"
"NWC"	"Actinokentia divaricata, Actinokentia huerlimannii, Basselinia deplanchei, Basselinia eriostachys, Basselinia favieri, Basselinia glabrata, Basselinia gracilis, Basselinia humboldtiana, Basselinia iterata, Basselinia moorei, Basselinia pancheri, Basselinia porphyrea, Basselinia sordida, Basselinia tomentosa, Basselinia velutina, Basselinia vestita, Burretiokentia dumasii, Burretiokentia grandiflora, Burretiokentia hapala, Burretiokentia koghiensis, Burretiokentia vieillardii, Chambeyronia lepidota, Chambeyronia macrocarpa, Clinosperma bracteale, Clinosperma lanuginosa, Clinosperma macrocarpa, Clinosperma vaginata, Cocos nucifera, Cyphokentia cerifera, Cyphokentia macrostachya, Cyphophoenix alba, Cyphophoenix elegans, Cyphophoenix fulcita, Cyphophoenix nucele, Cyphosperma balansae, Kentiopsis magnifica, Kentiopsis oliviformis, Kentiopsis piersoniorum, Kentiopsis pyriformis, Livistona chinensis, Phoenix dactylifera, Roystonea oleracea, Saribus jeanneneyi"
"NWG"	"Actinorhytis calapparia, Areca catechu, Areca congesta, Areca jokowi, Areca ledermanniana, Areca macrocalyx, Areca mandacanii, Areca unipa, Arenga microcarpa, Arenga pinnata, Borassus heineanus, Brassiophoenix drymophloeoides, Brassiophoenix schumannii, Calamus altiscandens, Calamus anomalus, Calamus aruensis, Calamus badius, Calamus baiyerensis, Calamus bankae, Calamus barbatus, Calamus barfodii, Calamus bulubabi, Calamus capillosus, Calamus cheirophyllus, Calamus croftii, Calamus cuthbertsonii, Calamus dasyacanthus, Calamus depauperatus, Calamus distentus, Calamus erythrocarpus, Calamus essigii, Calamus fertilis, Calamus heatubunii, Calamus heteracanthus, Calamus interruptus, Calamus jacobsii, Calamus johnsii, Calamus katikii, Calamus kebariensis, Calamus klossii, Calamus komsaryi, Calamus kostermansii, Calamus lauterbachii, Calamus longipinna, Calamus lucysmithiae, Calamus macrochlamys, Calamus maturbongsii, Calamus moszkowskianus, Calamus nanduensis, Calamus nannostachys, Calamus oresbius, Calamus pachypus, Calamus papuanus, Calamus papyraceus, Calamus pholidostachys, Calamus pilosissimus, Calamus pintaudii, Calamus polycladus, Calamus pseudozebrinus, Calamus reticulatus, Calamus retroflexus, Calamus sashae, Calamus scabrispathus, Calamus schlechterianus, Calamus serrulatus, Calamus spanostachys, Calamus spiculifer, Calamus superciliatus, Calamus vestitus, Calamus vitiensis, Calamus wanggaii, Calamus warburgii, Calamus womersleyi, Calamus zebrinus, Calamus zieckii, Calyptrocalyx albertisianus, Calyptrocalyx amoenus, Calyptrocalyx arfakianus, Calyptrocalyx awa, Calyptrocalyx caudiculatus, Calyptrocalyx doxanthus, Calyptrocalyx elegans, Calyptrocalyx flabellatus, Calyptrocalyx forbesii, Calyptrocalyx geonomiformis, Calyptrocalyx hollrungii, Calyptrocalyx julianettii, Calyptrocalyx lauterbachianus, Calyptrocalyx laxiflorus, Calyptrocalyx lepidotus, Calyptrocalyx leptostachys, Calyptrocalyx merrillianus, Calyptrocalyx micholitzii, Calyptrocalyx multifidus, Calyptrocalyx pachystachys, Calyptrocalyx pauciflorus, Calyptrocalyx polyphyllus, Calyptrocalyx pusillus, Calyptrocalyx sessiliflorus, Calyptrocalyx yamutumene, Caryota rumphiana, Caryota zebrina, Cocos nucifera, Corypha utan, Cyrtostachys bakeri, Cyrtostachys barbata, Cyrtostachys elegans, Cyrtostachys excelsa, Cyrtostachys glauca, Cyrtostachys loriae, Dransfieldia micrantha, Drymophloeus litigiosus, Drymophloeus oliviformis, Heterospathe annectens, Heterospathe arfakiana, Heterospathe barfodii, Heterospathe clemensiae, Heterospathe compsoclada, Heterospathe delicatula, Heterospathe elata, Heterospathe elegans, Heterospathe glabra, Heterospathe ledermanniana, Heterospathe lepidota, Heterospathe macgregorii, Heterospathe muelleriana, Heterospathe obriensis, Heterospathe pilosa, Heterospathe porcata, Heterospathe pulchra, Heterospathe pullenii, Heterospathe sphaerocarpa, Hydriastele affinis, Hydriastele aprica, Hydriastele beccariana, Hydriastele biakensis, Hydriastele brassii, Hydriastele cariosa, Hydriastele carrii, Hydriastele chaunostachys, Hydriastele costata, Hydriastele cyclopensis, Hydriastele dransfieldii, Hydriastele flabellata, Hydriastele geelvinkiana, Hydriastele gibbsiana, Hydriastele gracilis, Hydriastele ledermanniana, Hydriastele lepidota, Hydriastele longispatha, Hydriastele lurida, Hydriastele mayrii, Hydriastele micrantha, Hydriastele microspadix, Hydriastele montana, Hydriastele pinangoides, Hydriastele pleurocarpa, Hydriastele procera, Hydriastele rheophytica, Hydriastele rhopalocarpa, Hydriastele rostrata, Hydriastele valida, Hydriastele variabilis, Hydriastele wendlandiana, Korthalsia brassii, Korthalsia zippelii, Licuala angustiloba, Licuala anomala, Licuala aruensis, Licuala bacularia, Licuala beccariana, Licuala bellatula, Licuala bifida, Licuala brevicalyx, Licuala concinna, Licuala crassiflora, Licuala debilis, Licuala flavida, Licuala gjellerupii, Licuala graminifolia, Licuala grandiflora, Licuala insignis, Licuala klossii, Licuala lauterbachii, Licuala leprosa, Licuala leptocalyx, Licuala linearis, Licuala longispadix, Licuala macrantha, Licuala magna, Licuala micrantha, Licuala montana, Licuala moszkowskiana, Licuala naumoniensis, Licuala oninensis, Licuala pachycalyx, Licuala parviflora, Licuala paucisecta, Licuala penduliflora, Licuala platydactyla, Licuala polyschista, Licuala pulchella, Licuala robusta, Licuala simplex, Licuala steinii, Licuala tanycola, Licuala telifera, Licuala urciflora, Linospadix albertisianus, Linospadix caninus, Livistona benthamii, Livistona muelleri, Manjekia maturbongsii, Metroxylon sagu, Metroxylon salomonense, Nypa fruticans, Orania archboldiana, Orania bakeri, Orania dafonsoroensis, Orania deflexa, Orania disticha, Orania ferruginea, Orania gagavu, Orania glauca, Orania grandiflora, Orania lauterbachiana, Orania littoralis, Orania longistaminodia, Orania macropetala, Orania micrantha, Orania oreophila, Orania palindan, Orania parva, Orania regalis, Orania subdisticha, Orania tabubilensis, Orania timikae, Orania zonae, Pigafetta filaris, Pinanga rumphiana, Ptychococcus lepidotus, Ptychococcus paradoxus, Ptychosperma ambiguum, Ptychosperma buabe, Ptychosperma burretianum, Ptychosperma caryotoides, Ptychosperma cuneatum, Ptychosperma furcatum, Ptychosperma hartmannii, Ptychosperma lauterbachii, Ptychosperma lineare, Ptychosperma macarthurii, Ptychosperma macrocerum, Ptychosperma mambare, Ptychosperma microcarpum, Ptychosperma mooreanum, Ptychosperma nicolai, Ptychosperma praemorsum, Ptychosperma propinquum, Ptychosperma pullenii, Ptychosperma ramosissimum, Ptychosperma rosselense, Ptychosperma salomonense, Ptychosperma sanderianum, Ptychosperma schefferi, Ptychosperma streimannii, Ptychosperma tagulense, Ptychosperma vestitum, Ptychosperma waitianum, Rhopaloblaste ceramica, Rhopaloblaste ledermanniana, Saribus brevifolius, Saribus chocolatinus, Saribus papuanus, Saribus rotundifolius, Saribus surru, Saribus tothur, Saribus woodfordii, Sommieria leucophylla, Wallaceodoxa raja-ampat"
"NWH"	"NA"
"NWJ"	"NA"
"NWM"	"NA"
"NWT"	"NA"
"NWY"	"NA"
"NZN"	"Archontophoenix cunninghamiana, Phoenix canariensis, Rhopalostylis sapida, Washingtonia robusta"
"NZS"	"Rhopalostylis sapida"
"OFS"	"NA"
"OGA"	"Arenga ryukyuensis, Caryota urens, Clinostigma savoryanum, Cocos nucifera, Livistona boninensis"
"OHI"	"NA"
"OKL"	"Sabal minor"
"OMA"	"Nannorrhops ritchieana, Phoenix caespitosa, Phoenix dactylifera"
"ONT"	"NA"
"ORE"	"NA"
"PAK"	"Nannorrhops ritchieana, Phoenix dactylifera, Phoenix loureiroi, Phoenix sylvestris"
"PAL"	"Hyphaene thebaica"
"PAN"	"Acrocomia aculeata, Aiphanes hirsuta, Areca triandra, Asterogyne martiana, Astrocaryum alatum, Astrocaryum confertum, Astrocaryum standleyanum, Attalea allenii, Attalea iguadummat, Attalea rostrata, Bactris barronis, Bactris caudata, Bactris charnleyae, Bactris coloniata, Bactris coloradonis, Bactris dianeura, Bactris gasipaes, Bactris glandulosa, Bactris gracilior, Bactris guineensis, Bactris kunorum, Bactris major, Bactris maraja, Bactris militaris, Bactris obovata, Bactris panamensis, Bactris pilosa, Calyptrogyne allenii, Calyptrogyne anomala, Calyptrogyne coloradensis, Calyptrogyne condensata, Calyptrogyne costatifrons, Calyptrogyne deneversii, Calyptrogyne fortunensis, Calyptrogyne ghiesbreghtiana, Calyptrogyne kunorum, Calyptrogyne panamensis, Calyptrogyne pubescens, Calyptrogyne sanblasensis, Calyptrogyne tutensis, Chamaedorea allenii, Chamaedorea amabilis, Chamaedorea anemophila, Chamaedorea arenbergiana, Chamaedorea brachyclada, Chamaedorea correae, Chamaedorea costaricana, Chamaedorea dammeriana, Chamaedorea deckeriana, Chamaedorea deneversiana, Chamaedorea guntheriana, Chamaedorea lucidifrons, Chamaedorea macrospadix, Chamaedorea matae, Chamaedorea microphylla, Chamaedorea palmeriana, Chamaedorea pinnatifrons, Chamaedorea pittieri, Chamaedorea ponderosa, Chamaedorea pumila, Chamaedorea pygmaea, Chamaedorea recurvata, Chamaedorea robertii, Chamaedorea rossteniorum, Chamaedorea scheryi, Chamaedorea serpens, Chamaedorea stenocarpa, Chamaedorea stricta, Chamaedorea subjectifolia, Chamaedorea tepejilote, Chamaedorea verecunda, Chamaedorea warscewiczii, Chamaedorea woodsoniana, Colpothrinax aphanopetala, Cryosophila bartlettii, Cryosophila guagara, Cryosophila kalbreyeri, Cryosophila warscewiczii, Desmoncus cirrhifer, Desmoncus kunarius, Desmoncus myriacanthos, Desmoncus obovoideus, Dictyocaryum lamarckianum, Elaeis oleifera, Euterpe precatoria, Geonoma calyptrogynoidea, Geonoma concinnoidea, Geonoma congesta, Geonoma cuneata, Geonoma deneversii, Geonoma deversa, Geonoma epetiolata, Geonoma hugonis, Geonoma interrupta, Geonoma lehmannii, Geonoma longivaginata, Geonoma monospatha, Geonoma mooreana, Geonoma orbignyana, Geonoma pinnatifrons, Geonoma talamancana, Geonoma triandra, Geonoma undata, Hyospathe elegans, Hyospathe pittieri, Iriartea deltoidea, Manicaria saccifera, Neonicholsonia watsonii, Nypa fruticans, Oenocarpus bataua, Oenocarpus mapora, Pholidostachys dactyloides, Pholidostachys kalbreyeri, Pholidostachys panamensis, Pholidostachys pulchra, Phytelephas macrocarpa, Prestoea acuminata, Prestoea decurrens, Prestoea ensiformis, Prestoea longepetiolata, Prestoea pubens, Prestoea schultzeana, Ptychosperma macarthurii, Raphia taedigera, Reinhardtia gracilis, Reinhardtia koschnyana, Reinhardtia simplex, Roystonea regia, Sabal mauritiiformis, Socratea exorrhiza, Synechanthus dasystachys, Synechanthus fibrosus, Synechanthus warscewiczianus, Welfia regia, Wettinia aequalis, Wettinia panamensis, Wettinia radiata"
"PAR"	"Acrocomia hassleri, Acrocomia totai, Allagoptera campestris, Allagoptera leucocalyx, Attalea anisitsiana, Attalea geraensis, Bactris glaucescens, Butia arenicola, Butia campicola, Butia exospadix, Butia lepidotispatha, Butia leptospatha, Butia marmorii, Butia paraguayensis, Copernicia alba, Desmoncus leptoclonos, Euterpe edulis, Geonoma pohliana, Syagrus campylospatha, Syagrus cerqueirana, Syagrus lilliputiana, Syagrus oleracea, Syagrus romanzoffiana, Trithrinax brasiliensis, Trithrinax schizophylla"
"PEI"	"NA"
"PEN"	"NA"
"PER"	"Aiphanes deltoidea, Aiphanes horrida, Aiphanes spicata, Aiphanes ulei, Aiphanes weberbaueri, Aphandra natalia, Astrocaryum aculeatum, Astrocaryum carnosum, Astrocaryum chambira, Astrocaryum chonta, Astrocaryum ciliatum, Astrocaryum faranae, Astrocaryum gratum, Astrocaryum huaimi, Astrocaryum huicungo, Astrocaryum jauari, Astrocaryum javarense, Astrocaryum macrocalyx, Astrocaryum perangustatum, Astrocaryum scopatum, Astrocaryum ulei, Astrocaryum urostachys, Attalea bassleriana, Attalea butyracea, Attalea cephalotus, Attalea insignis, Attalea kewensis, Attalea maripa, Attalea microcarpa, Attalea moorei, Attalea peruviana, Attalea phalerata, Attalea plowmanii, Attalea racemosa, Attalea salazarii, Attalea tessmannii, Attalea weberbaueri, Bactris acanthocarpa, Bactris bidentula, Bactris bifida, Bactris brongniartii, Bactris chaveziae, Bactris coloniata, Bactris concinna, Bactris corossilla, Bactris fissifrons, Bactris gasipaes, Bactris halmoorei, Bactris hirta, Bactris killipii, Bactris macroacantha, Bactris major, Bactris maraja, Bactris martiana, Bactris riparia, Bactris schultesii, Bactris setulosa, Bactris simplicifrons, Bactris sphaerocarpa, Ceroxylon echinulatum, Ceroxylon parvifrons, Ceroxylon peruvianum, Ceroxylon pityrophyllum, Ceroxylon quindiuense, Ceroxylon vogelianum, Chamaedorea angustisecta, Chamaedorea fragrans, Chamaedorea linearis, Chamaedorea pauciflora, Chamaedorea pinnatifrons, Chamaedorea smithii, Chelyocarpus repens, Chelyocarpus ulei, Desmoncus giganteus, Desmoncus loretanus, Desmoncus madrensis, Desmoncus mitis, Desmoncus polyacanthos, Desmoncus prunifer, Desmoncus vacivus, Dictyocaryum lamarckianum, Dictyocaryum ptarianum, Elaeis oleifera, Euterpe catinga, Euterpe luminosa, Euterpe precatoria, Geonoma brongniartii, Geonoma camana, Geonoma deversa, Geonoma euspatha, Geonoma interrupta, Geonoma laxiflora, Geonoma lehmannii, Geonoma leptospadix, Geonoma longepedunculata, Geonoma macrostachys, Geonoma maxima, Geonoma occidentalis, Geonoma orbignyana, Geonoma peruviana, Geonoma poeppigiana, Geonoma sanmartinensis, Geonoma schizocarpa, Geonoma stricta, Geonoma triglochin, Geonoma trigona, Geonoma undata, Hyospathe elegans, Hyospathe peruviana, Iriartea deltoidea, Iriartella stenocarpa, Itaya amicorum, Lepidocaryum tenue, Manicaria saccifera, Mauritia carana, Mauritia flexuosa, Mauritiella armata, Oenocarpus balickii, Oenocarpus bataua, Oenocarpus distichus, Oenocarpus mapora, Parajubaea cocoides, Pholidostachys amazonensis, Pholidostachys synanthera, Phytelephas macrocarpa, Phytelephas tenuicaulis, Prestoea acuminata, Prestoea carderi, Prestoea ensiformis, Prestoea schultzeana, Socratea exorrhiza, Socratea rostrata, Socratea salazarii, Syagrus sancona, Syagrus smithii, Welfia alfredii, Wendlandiella gracilis, Wettinia augusta, Wettinia drudei, Wettinia longipetala, Wettinia maynensis"
"PHI"	"Adonidia merrillii, Areca caliso, Areca camarinensis, Areca catechu, Areca costulata, Areca hutchinsoniana, Areca ipot, Areca parens, Areca triandra, Areca vidaliana, Areca whitfordii, Arenga mindorensis, Arenga pinnata, Arenga tremula, Arenga undulatifolia, Calamus affinis, Calamus aidae, Calamus arugda, Calamus balerensis, Calamus batanensis, Calamus bicolor, Calamus caesius, Calamus clemensianus, Calamus cumingianus, Calamus curranii, Calamus daemonoropoides, Calamus diepenhorstii, Calamus discolor, Calamus erinaceus, Calamus filispadix, Calamus flexilis, Calamus foxworthyi, Calamus grandifolius, Calamus javensis, Calamus jenningsianus, Calamus loherianus, Calamus longipes, Calamus malawaliensis, Calamus manillensis, Calamus marginatus, Calamus megaphyllus, Calamus melanorhynchus, Calamus merrillii, Calamus microsphaerion, Calamus mitis, Calamus mollis, Calamus moseleyanus, Calamus nicolai, Calamus ochrolepis, Calamus oligolepis, Calamus ornatus, Calamus pannosus, Calamus pedicellaris, Calamus plicatus, Calamus politus, Calamus reyesianus, Calamus samian, Calamus scipionum, Calamus siphonospathus, Calamus spinifolius, Calamus symphysipus, Calamus urdanetanus, Calamus usitatus, Calamus vidalianus, Calamus vinosus, Calamus viridissimus, Caryota cumingii, Caryota maxima, Caryota mitis, Caryota rumphiana, Cocos nucifera, Corypha microclada, Corypha utan, Heterospathe brevicaulis, Heterospathe cagayanensis, Heterospathe califrons, Heterospathe dransfieldii, Heterospathe elata, Heterospathe elmeri, Heterospathe intermedia, Heterospathe negrosensis, Heterospathe philippinensis, Heterospathe scitula, Heterospathe sibuyanensis, Heterospathe trispatha, Korthalsia laciniosa, Korthalsia merrillii, Korthalsia rigida, Korthalsia robusta, Korthalsia scaphigeroides, Licuala spinosa, Livistona saribus, Nypa fruticans, Oncosperma gracilipes, Oncosperma horridum, Oncosperma platyphyllum, Orania decipiens, Orania palindan, Orania paraguanensis, Phoenix loureiroi, Pinanga basilanensis, Pinanga batanensis, Pinanga bicolana, Pinanga copelandii, Pinanga curranii, Pinanga egregia, Pinanga geonomiformis, Pinanga glaucifolia, Pinanga heterophylla, Pinanga insignis, Pinanga isabelensis, Pinanga maculata, Pinanga modesta, Pinanga negrosensis, Pinanga philippinensis, Pinanga rigida, Pinanga samarana, Pinanga sclerophylla, Pinanga sierramadreana, Pinanga sobolifera, Pinanga speciosa, Pinanga urdanetensis, Pinanga urosperma, Pinanga woodiana, Plectocomia elmeri, Plectocomia elongata, Salacca clemensiana, Salacca ramosiana, Saribus merrillii, Saribus rotundifolius"
"PHX"	"Cocos nucifera"
"PIT"	"NA"
"POL"	"NA"
"POR"	"Chamaerops humilis"
"PRM"	"NA"
"PUE"	"Acrocomia media, Adonidia merrillii, Aiphanes acanthophylla, Areca catechu, Calyptronoma rivalis, Caryota mitis, Caryota urens, Coccothrinax alta, Cocos nucifera, Dypsis lutescens, Elaeis guineensis, Gaussia attenuata, Leucothrinax morrisii, Livistona chinensis, Phoenix dactylifera, Phoenix reclinata, Phoenix rupicola, Phoenix sylvestris, Prestoea acuminata, Pseudophoenix sargentii, Roystonea borinquena, Roystonea regia, Sabal causiarum"
"QLD"	"Archontophoenix alexandrae, Archontophoenix cunninghamiana, Archontophoenix maxima, Archontophoenix myolensis, Archontophoenix purpurea, Archontophoenix tuckeri, Arenga australasica, Calamus aruensis, Calamus australis, Calamus caryotoides, Calamus moti, Calamus muelleri, Calamus radicalis, Calamus vitiensis, Calamus warburgii, Caryota alberti, Cocos nucifera, Corypha utan, Hydriastele costata, Hydriastele wendlandiana, Laccospadix australasicus, Licuala ramsayi, Linospadix apetiolatus, Linospadix microcaryus, Linospadix minor, Linospadix monostachyos, Linospadix palmerianus, Livistona australis, Livistona benthamii, Livistona concinna, Livistona decora, Livistona drudei, Livistona fulva, Livistona inermis, Livistona lanuginosa, Livistona muelleri, Livistona nitida, Livistona rigida, Normanbya normanbyi, Nypa fruticans, Oraniopsis appendiculata, Phoenix dactylifera, Ptychosperma elegans, Ptychosperma macarthurii, Syagrus romanzoffiana, Wodyetia bifurcata"
"QUE"	"NA"
"REU"	"Acanthophoenix crinita, Acanthophoenix rousselii, Acanthophoenix rubra, Cocos nucifera, Dictyosperma album, Dypsis lutescens, Hyophorbe indica, Latania lontaroides, Livistona chinensis, Phoenix dactylifera, Raphia farinifera, Roystonea oleracea, Washingtonia robusta"
"RHO"	"NA"
"ROD"	"Dictyosperma album, Hyophorbe verschaffeltii, Latania verschaffeltii"
"ROM"	"NA"
"RUC"	"NA"
"RUE"	"NA"
"RUN"	"NA"
"RUS"	"NA"
"RUW"	"NA"
"RWA"	"Elaeis guineensis, Hyphaene petersiana, Phoenix reclinata, Raphia ruwenzorica"
"SAK"	"NA"
"SAM"	"Balaka insularis, Balaka samoensis, Balaka tahitensis, Calamus caesius, Clinostigma onchorhynchum, Clinostigma samoense, Clinostigma warburgii, Cocos nucifera, Drymophloeus whitmeeanus, Metroxylon paulcoxii, Metroxylon upoluense, Metroxylon warburgii, Pritchardia pacifica"
"SAR"	"Chamaerops humilis"
"SAS"	"NA"
"SAU"	"Hyphaene thebaica, Phoenix caespitosa, Phoenix dactylifera, Phoenix reclinata"
"SCA"	"Cocos nucifera, Rhapidophyllum hystrix, Sabal minor, Sabal palmetto, Serenoa repens"
"SCI"	"Areca catechu, Cocos nucifera, Dypsis madagascariensis, Elaeis guineensis, Heterospathe elata, Licuala grandis, Livistona australis, Livistona saribus, Nypa fruticans, Oncosperma tigillarium, Pinanga coronata, Pritchardia pacifica, Ptychosperma elegans, Ptychosperma macarthurii"
"SCS"	"Cocos nucifera"
"SCZ"	"Areca catechu, Cocos nucifera, Hydriastele cylindrocarpa, Licuala grandis, Metroxylon sagu, Metroxylon salomonense, Metroxylon warburgii"
"SDA"	"NA"
"SEL"	"NA"
"SEN"	"Borassus aethiopum, Borassus akeassii, Calamus deerratus, Cocos nucifera, Elaeis guineensis, Hyphaene thebaica, Laccosperma secundiflorum, Phoenix dactylifera, Phoenix reclinata, Raphia farinifera, Raphia palma-pinus, Raphia sudanica"
"SEY"	"Cocos nucifera, Deckenia nobilis, Lodoicea maldivica, Nephrosperma vanhoutteanum, Phoenicophorium borsigianum, Raphia farinifera, Roscheria melanochaetes, Verschaffeltia splendida"
"SGE"	"NA"
"SIC"	"Chamaerops humilis, Phoenix canariensis, Washingtonia filifera"
"SIE"	"Calamus deerratus, Elaeis guineensis, Eremospatha dransfieldii, Eremospatha laurentii, Eremospatha macrocarpa, Hyphaene thebaica, Laccosperma acutiflorum, Laccosperma secundiflorum, Phoenix reclinata, Raphia farinifera, Raphia hookeri, Raphia palma-pinus, Raphia sudanica"
"SIN"	"Hyphaene thebaica, Phoenix dactylifera"
"SOA"	"Phoenix canariensis, Phoenix dactylifera"
"SOC"	"Borassus flabellifer, Phoenix dactylifera"
"SOL"	"Actinorhytis calapparia, Areca catechu, Areca macrocalyx, Areca novohibernica, Calamus aruensis, Calamus longipinna, Calamus novae-georgii, Calamus vitiensis, Caryota rumphiana, Clinostigma gronophyllum, Clinostigma haerestigma, Cocos nucifera, Cyrtostachys loriae, Heterospathe kajewskii, Heterospathe minor, Heterospathe ramulosa, Heterospathe salomonensis, Heterospathe sensisi, Heterospathe woodfordiana, Hydriastele hombronii, Hydriastele macrospadix, Licuala lauterbachii, Licuala naumannii, Metroxylon sagu, Metroxylon salomonense, Nypa fruticans, Pelagodoxa henryana, Physokentia dennisii, Physokentia insolita, Physokentia whitmorei, Pritchardia pacifica, Ptychococcus paradoxus, Ptychosperma salomonense, Rhopaloblaste elegans, Saribus woodfordii, Veitchia lepidota, Veitchia pachyclada, Veitchia subdisticha"
"SOM"	"Hyphaene compressa, Hyphaene coriacea, Hyphaene reptans, Hyphaene thebaica, Livistona carinensis, Phoenix caespitosa, Phoenix dactylifera, Phoenix reclinata"
"SPA"	"Chamaerops humilis, Phoenix canariensis, Phoenix dactylifera, Washingtonia filifera, Washingtonia robusta"
"SRL"	"Areca catechu, Areca concinna, Borassus flabellifer, Calamus delicatulus, Calamus digitatus, Calamus metzianus, Calamus ovoideus, Calamus pachystemonus, Calamus pseudotenuis, Calamus radiatus, Calamus rotang, Calamus thwaitesii, Calamus zeylanicus, Caryota urens, Cocos nucifera, Corypha umbraculifera, Elaeis guineensis, Hyphaene dichotoma, Loxococcus rupicola, Nypa fruticans, Oncosperma fasciculatum, Phoenix pusilla, Phoenix sylvestris"
"SSA"	"NA"
"STH"	"NA"
"SUD"	"Borassus aethiopum, Calamus deerratus, Elaeis guineensis, Hyphaene thebaica, Medemia argun, Phoenix dactylifera, Phoenix reclinata, Raphia mambillensis, Raphia monbuttorum"
"SUL"	"Areca catechu, Areca oxycarpa, Areca vestiaria, Arenga pinnata, Arenga undulatifolia, Borassus flabellifer, Calamus boniensis, Calamus didymocarpus, Calamus inops, Calamus kandariensis, Calamus kjellbergii, Calamus koordersianus, Calamus lamprolepis, Calamus leiocaulis, Calamus leptostachys, Calamus macropterus, Calamus macrosphaerion, Calamus minahassae, Calamus mogeanus, Calamus moseleyanus, Calamus ornatus, Calamus orthostachyus, Calamus pedicellatus, Calamus riedelianus, Calamus robinsonianus, Calamus sarasinorum, Calamus schlechteri, Calamus scleracanthus, Calamus siphonospathus, Calamus suaveolens, Calamus symphysipus, Calamus takanensis, Calamus toli-toliensis, Calamus usitatus, Calamus validus, Calamus zollingeri, Caryota angustifolia, Caryota mitis, Caryota rumphiana, Cocos nucifera, Corypha utan, Hydriastele kjellbergii, Hydriastele nannostachys, Hydriastele sarasinorum, Hydriastele selebica, Korthalsia celebica, Licuala bissula, Licuala celebica, Nypa fruticans, Oncosperma horridum, Orania palindan, Pholidocarpus ihur, Pigafetta elata, Pinanga caesia, Pinanga celebica, Pinanga furfuracea, Pinanga inaequalis, Pinanga insignis, Pinanga minor, Pinanga rumphiana, Salacca zalacca, Saribus rotundifolius"
"SUM"	"Actinorhytis calapparia, Areca catechu, Areca montana, Areca triandra, Areca triginticollina, Areca tunku, Arenga brevipes, Arenga hastata, Arenga longipes, Arenga obtusifolia, Arenga plicata, Arenga porphyrocarpa, Arenga talamauensis, Calamus acehensis, Calamus asperrimus, Calamus axillaris, Calamus billitonensis, Calamus binnendijkii, Calamus brachypodus, Calamus caesius, Calamus calicarpus, Calamus castaneus, Calamus ciliaris, Calamus concolor, Calamus confusus, Calamus conirostris, Calamus crinitus, Calamus densiflorus, Calamus depressiusculus, Calamus didymophyllus, Calamus diepenhorstii, Calamus draco, Calamus dracunculus, Calamus erinaceus, Calamus erioacanthus, Calamus exilis, Calamus flabellatus, Calamus forbesii, Calamus geniculatus, Calamus gracilipes, Calamus griseus, Calamus hallierianus, Calamus heteroideus, Calamus hirsutus, Calamus horridus, Calamus insignis, Calamus javensis, Calamus johndransfieldii, Calamus karuensis, Calamus lewisianus, Calamus lobbianus, Calamus longipes, Calamus longispinosus, Calamus manan, Calamus marginatus, Calamus megalocarpus, Calamus melanochaetes, Calamus micranthus, Calamus mogeae, Calamus ornatus, Calamus oxleyanus, Calamus palembanicus, Calamus pandanosmus, Calamus parvifructus, Calamus paspalanthus, Calamus periacanthus, Calamus plagiocyclus, Calamus plicatus, Calamus polystachys, Calamus pseudoconcolor, Calamus rhomboideus, Calamus rugosus, Calamus scabridulus, Calamus scapigerus, Calamus scipionum, Calamus sedens, Calamus sekundurensis, Calamus siberutensis, Calamus singalanus, Calamus spectatissimus, Calamus stenophyllus, Calamus subangulatus, Calamus tenuis, Calamus trichrous, Calamus tumidus, Calamus unifarius, Calamus uschdraweitianus, Calamus verticillaris, Caryota maxima, Caryota mitis, Cocos nucifera, Corypha utan, Cyrtostachys renda, Elaeis guineensis, Eleiodoxa conferta, Iguanura leucocarpa, Iguanura wallichiana, Johannesteijsmannia altifrons, Korthalsia debilis, Korthalsia echinometra, Korthalsia flagellaris, Korthalsia hispida, Korthalsia laciniosa, Korthalsia paucijuga, Korthalsia rigida, Korthalsia robusta, Korthalsia rostrata, Licuala elegans, Licuala ferruginoides, Licuala longipes, Licuala nana, Licuala paludosa, Licuala spinosa, Licuala triphylla, Metroxylon sagu, Myrialepis paradoxa, Nenga gajah, Nenga pumila, Nypa fruticans, Oncosperma horridum, Oncosperma tigillarium, Orania sylvicola, Phoenix paludosa, Pholidocarpus macrocarpus, Pholidocarpus mucronatus, Pholidocarpus sumatranus, Pinanga coronata, Pinanga densiflora, Pinanga disticha, Pinanga forbesii, Pinanga glauca, Pinanga grandijuga, Pinanga grandis, Pinanga latisecta, Pinanga macrospadix, Pinanga malaiana, Pinanga megalocarpa, Pinanga micholitzii, Pinanga pachycarpa, Pinanga parvula, Pinanga patula, Pinanga porrecta, Pinanga pulchella, Pinanga purpurea, Pinanga riparia, Pinanga simplicifrons, Pinanga stylosa, Pinanga subintegra, Pinanga uncinata, Plectocomia billitonensis, Plectocomia elongata, Plectocomia lorzingii, Plectocomiopsis corneri, Plectocomiopsis geminiflora, Plectocomiopsis mira, Rhapis subtilis, Salacca acehensis, Salacca affinis, Salacca sumatrana, Salacca wallichiana, Salacca zalacca"
"SUR"	"Acrocomia aculeata, Astrocaryum aculeatum, Astrocaryum farinosum, Astrocaryum jauari, Astrocaryum murumuru, Astrocaryum paramaca, Astrocaryum rodriguesii, Astrocaryum sciophilum, Astrocaryum tucuma, Astrocaryum vulgare, Attalea attaleoides, Attalea dahlgreniana, Attalea maripa, Attalea microcarpa, Attalea speciosa, Bactris acanthocarpa, Bactris acanthocarpoides, Bactris aubletiana, Bactris brongniartii, Bactris campestris, Bactris constanciae, Bactris cuspidata, Bactris elegans, Bactris gastoniana, Bactris hirta, Bactris major, Bactris maraja, Bactris oligocarpa, Bactris pliniana, Bactris rhaphidacantha, Bactris setulosa, Bactris simplicifrons, Bactris turbinocarpa, Desmoncus horridus, Desmoncus parvulus, Desmoncus polyacanthos, Elaeis oleifera, Euterpe oleracea, Euterpe precatoria, Geonoma baculifera, Geonoma deversa, Geonoma euspatha, Geonoma leptospadix, Geonoma maxima, Geonoma poiteauana, Geonoma stricta, Geonoma undata, Hyospathe elegans, Manicaria saccifera, Mauritia flexuosa, Mauritiella armata, Oenocarpus bacaba, Oenocarpus bataua, Socratea exorrhiza, Syagrus inajai, Syagrus stratincola"
"SVA"	"NA"
"SWC"	"Acoelorrhaphe wrightii, Coccothrinax argentata, Cocos nucifera"
"SWE"	"NA"
"SWI"	"Trachycarpus fortunei"
"SWZ"	"Phoenix reclinata"
"TAI"	"Areca catechu, Arenga engleri, Calamus batanensis, Calamus beccarii, Calamus formosanus, Calamus jenkinsianus, Calamus siphonospathus, Cocos nucifera, Livistona chinensis, Phoenix loureiroi, Pinanga tashiroi"
"TAN"	"Borassus aethiopum, Cocos nucifera, Dypsis pembana, Elaeis guineensis, Eremospatha haullevilleana, Hyphaene compressa, Hyphaene coriacea, Hyphaene petersiana, Phoenix reclinata, Raphia farinifera"
"TAS"	"NA"
"TCI"	"Coccothrinax argentata, Coccothrinax inaguensis, Leucothrinax morrisii, Pseudophoenix sargentii, Sabal palmetto"
"TCS"	"NA"
"TDC"	"NA"
"TEN"	"NA"
"TEX"	"Sabal mexicana, Sabal minor"
"THA"	"Actinorhytis calapparia, Areca catechu, Areca laosensis, Areca montana, Areca triandra, Areca tunku, Arenga caudata, Arenga hastata, Arenga hookeriana, Arenga obtusifolia, Arenga pinnata, Arenga westerhoutii, Borassodendron machadonis, Borassus flabellifer, Calamus acanthophyllus, Calamus acanthospathus, Calamus angustifolius, Calamus arborescens, Calamus axillaris, Calamus balingensis, Calamus bousigonii, Calamus burkillianus, Calamus caesius, Calamus castaneus, Calamus concinnus, Calamus densiflorus, Calamus didymophyllus, Calamus diepenhorstii, Calamus draco, Calamus erectus, Calamus erinaceus, Calamus exilis, Calamus flagellum, Calamus geniculatus, Calamus godefroyi, Calamus grandis, Calamus griseus, Calamus helferianus, Calamus henryanus, Calamus inermis, Calamus insignis, Calamus javensis, Calamus jenkinsianus, Calamus kunstleri, Calamus kurzianus, Calamus latifolius, Calamus leptopus, Calamus lewisianus, Calamus longisetus, Calamus macrophyllus, Calamus manan, Calamus melanochaetes, Calamus micranthus, Calamus monticola, Calamus myrianthus, Calamus nitidus, Calamus oligostachys, Calamus ornatus, Calamus pandanosmus, Calamus peregrinus, Calamus platyspathus, Calamus plicatus, Calamus poilanei, Calamus radulosus, Calamus rhomboideus, Calamus rudentum, Calamus sabut, Calamus scipionum, Calamus sedens, Calamus sepal, Calamus simplex, Calamus spectatissimus, Calamus subangulatus, Calamus temii, Calamus tenuis, Calamus tetradactylus, Calamus verticillaris, Calamus viminalis, Caryota kiriwongensis, Caryota maxima, Caryota mitis, Caryota obtusa, Cocos nucifera, Corypha lecomtei, Corypha umbraculifera, Corypha utan, Cyrtostachys renda, Eleiodoxa conferta, Eugeissona tristis, Iguanura bicornis, Iguanura divergens, Iguanura geonomiformis, Iguanura polymorpha, Iguanura speciosa, Iguanura tenuis, Iguanura thalangensis, Iguanura wallichiana, Johannesteijsmannia altifrons, Kerriodoxa elegans, Korthalsia flagellaris, Korthalsia laciniosa, Korthalsia rigida, Korthalsia rostrata, Korthalsia scortechinii, Licuala distans, Licuala glabra, Licuala kunstleri, Licuala malajana, Licuala merguensis, Licuala modesta, Licuala paludosa, Licuala peltata, Licuala pitta, Licuala poonsakii, Licuala pusilla, Licuala scortechinii, Licuala spinosa, Licuala triphylla, Livistona jenkinsiana, Livistona saribus, Livistona speciosa, Maxburretia furtadoana, Maxburretia gracilis, Metroxylon sagu, Myrialepis paradoxa, Nenga macrocarpa, Nenga pumila, Nypa fruticans, Oncosperma horridum, Oncosperma tigillarium, Orania sylvicola, Phoenix loureiroi, Phoenix paludosa, Phoenix roebelenii, Pholidocarpus macrocarpus, Pinanga adangensis, Pinanga auriculata, Pinanga badia, Pinanga disticha, Pinanga fractiflexa, Pinanga glaucescens, Pinanga malaiana, Pinanga paradoxa, Pinanga perakensis, Pinanga polymorpha, Pinanga riparia, Pinanga scortechinii, Pinanga simplicifrons, Pinanga subintegra, Pinanga sylvestris, Pinanga watanaiana, Plectocomia elongata, Plectocomia himalayana, Plectocomia pierreana, Plectocomiopsis geminiflora, Plectocomiopsis wrayi, Rhapis excelsa, Rhapis laosensis, Rhapis subtilis, Salacca glabrescens, Salacca griffithii, Salacca stolonifera, Salacca wallichiana, Trachycarpus oreophilus, Wallichia caryotoides, Wallichia disticha, Wallichia marianneae"
"TKM"	"NA"
"TOG"	"Borassus aethiopum, Cocos nucifera, Elaeis guineensis, Hyphaene thebaica, Laccosperma secundiflorum, Phoenix reclinata, Raphia farinifera, Raphia hookeri, Raphia sudanica, Raphia vinifera"
"TOK"	"Cocos nucifera, Pritchardia pacifica"
"TON"	"Cocos nucifera, Pritchardia pacifica, Pritchardia thurstonii, Veitchia joannis"
"TRT"	"Acrocomia aculeata, Adonidia merrillii, Aiphanes horrida, Aiphanes minima, Archontophoenix alexandrae, Archontophoenix cunninghamiana, Areca catechu, Areca triandra, Arenga pinnata, Arenga wightii, Astrocaryum tucuma, Attalea cohune, Attalea maripa, Attalea osmantha, Bactris campestris, Bactris gasipaes, Bactris major, Bactris setulosa, Bactris simplicifrons, Borassus aethiopum, Calamus mitis, Calamus rotang, Caryota mitis, Caryota urens, Coccothrinax barbadensis, Cocos nucifera, Copernicia prunifera, Corypha umbraculifera, Corypha utan, Cryosophila nana, Cyrtostachys renda, Deckenia nobilis, Desmoncus horridus, Desmoncus polyacanthos, Dictyosperma album, Dypsis lutescens, Elaeis guineensis, Euterpe broadwayi, Euterpe oleracea, Euterpe precatoria, Geonoma pinnatifrons, Hyophorbe verschaffeltii, Latania loddigesii, Latania lontaroides, Leucothrinax morrisii, Licuala grandis, Licuala spinosa, Livistona chinensis, Manicaria saccifera, Mauritia flexuosa, Nypa fruticans, Oenocarpus bataua, Phoenix acaulis, Phoenix dactylifera, Phoenix reclinata, Phoenix roebelenii, Phoenix rupicola, Phytelephas macrocarpa, Pinanga coronata, Prestoea acuminata, Prestoea pubigera, Pritchardia pacifica, Pritchardia thurstonii, Ptychosperma macarthurii, Raphia farinifera, Rhapis excelsa, Rhopaloblaste augusta, Roystonea oleracea, Roystonea regia, Sabal bermudana, Sabal mauritiiformis, Sabal minor, Sabal palmetto, Saribus rotundifolius, Syagrus amara, Syagrus romanzoffiana, Syagrus sancona, Thrinax radiata, Verschaffeltia splendida, Wallichia nana"
"TUA"	"Cocos nucifera, Pritchardia mitiaroana, Pritchardia vuylstekeana"
"TUB"	"Cocos nucifera"
"TUE"	"NA"
"TUN"	"Chamaerops humilis, Phoenix canariensis, Phoenix dactylifera"
"TUR"	"Phoenix dactylifera, Phoenix theophrasti"
"TUV"	"Cocos nucifera"
"TVA"	"NA"
"TVL"	"Borassus aethiopum, Hyphaene coriacea, Hyphaene petersiana, Phoenix reclinata"
"TZK"	"NA"
"UGA"	"Borassus aethiopum, Calamus deerratus, Elaeis guineensis, Eremospatha haullevilleana, Phoenix reclinata, Raphia farinifera"
"UKR"	"NA"
"URU"	"Butia lallemantii, Butia odorata, Butia yatay, Syagrus romanzoffiana, Trithrinax brasiliensis, Trithrinax campestris"
"UTA"	"NA"
"UZB"	"NA"
"VAN"	"Areca catechu, Calamus vitiensis, Carpoxylon macrospermum, Caryota ophiopellis, Clinostigma harlandii, Cocos nucifera, Cyphosperma voutmelense, Heterospathe uniformis, Hydriastele cylindrocarpa, Licuala cabalionii, Licuala grandis, Metroxylon salomonense, Metroxylon warburgii, Neoveitchia brunnea, Pelagodoxa henryana, Physokentia tete, Pritchardia pacifica, Veitchia arecina, Veitchia metiti, Veitchia spiralis, Veitchia winin"
"VEN"	"Acrocomia aculeata, Aiphanes horrida, Aiphanes lindeniana, Asterogyne ramosa, Asterogyne spicata, Asterogyne yaracuyense, Astrocaryum acaule, Astrocaryum aculeatum, Astrocaryum chambira, Astrocaryum jauari, Astrocaryum murumuru, Astrocaryum tucuma, Attalea butyracea, Attalea luetzelburgii, Attalea macrolepis, Attalea maracaibensis, Attalea maripa, Attalea microcarpa, Attalea osmantha, Attalea racemosa, Attalea wesselsboeri, Bactris acanthocarpa, Bactris balanophora, Bactris bidentula, Bactris brongniartii, Bactris campestris, Bactris corossilla, Bactris gasipaes, Bactris guineensis, Bactris hirta, Bactris major, Bactris maraja, Bactris oligoclada, Bactris pilosa, Bactris ptariana, Bactris setulosa, Bactris simplicifrons, Ceroxylon alpinum, Ceroxylon ceriferum, Ceroxylon parvifrons, Ceroxylon vogelianum, Chamaedorea linearis, Chamaedorea pinnatifrons, Coccothrinax barbadensis, Cocos nucifera, Copernicia berteroana, Copernicia tectorum, Desmoncus horridus, Desmoncus myriacanthos, Desmoncus parvulus, Desmoncus polyacanthos, Dictyocaryum fuscum, Dictyocaryum lamarckianum, Dictyocaryum ptarianum, Euterpe catinga, Euterpe longibracteata, Euterpe oleracea, Euterpe precatoria, Geonoma baculifera, Geonoma braunii, Geonoma brongniartii, Geonoma cuneata, Geonoma deversa, Geonoma euspatha, Geonoma interrupta, Geonoma lehmannii, Geonoma leptospadix, Geonoma macrostachys, Geonoma maxima, Geonoma oligoclona, Geonoma operculata, Geonoma orbignyana, Geonoma pinnatifrons, Geonoma poiteauana, Geonoma simplicifrons, Geonoma spinescens, Geonoma stricta, Geonoma undata, Hyospathe elegans, Hyospathe pittieri, Iriartea deltoidea, Iriartella setigera, Leopoldinia piassaba, Leopoldinia pulchra, Lepidocaryum tenue, Manicaria saccifera, Mauritia carana, Mauritia flexuosa, Mauritiella aculeata, Mauritiella armata, Mauritiella pumila, Oenocarpus bacaba, Oenocarpus balickii, Oenocarpus bataua, Oenocarpus mapora, Prestoea acuminata, Prestoea carderi, Prestoea longepetiolata, Prestoea pubigera, Prestoea tenuiramosa, Roystonea oleracea, Sabal mauritiiformis, Socratea exorrhiza, Socratea karstenii, Syagrus orinocensis, Syagrus sancona, Syagrus stenopetala, Wettinia praemorsa"
"VER"	"NA"
"VIC"	"Livistona australis, Phoenix canariensis"
"VIE"	"Areca catechu, Areca laosensis, Areca songthanhensis, Areca triandra, Arenga caudata, Arenga westerhoutii, Borassus flabellifer, Calamus acanthospathus, Calamus acaulis, Calamus albidus, Calamus bachmaensis, Calamus bousigonii, Calamus brevicaulis, Calamus centralis, Calamus ceratophorus, Calamus dianbaiensis, Calamus dioicus, Calamus dongnaiensis, Calamus eugenei, Calamus fissilis, Calamus flagellum, Calamus gracilis, Calamus henryanus, Calamus inermis, Calamus jenkinsianus, Calamus kontumensis, Calamus lateralis, Calamus latifolius, Calamus modestus, Calamus mollispinus, Calamus nuichuaensis, Calamus ocreatus, Calamus parvulus, Calamus poilanei, Calamus quangngaiensis, Calamus rhabdocladus, Calamus rudentum, Calamus salicifolius, Calamus seriatus, Calamus spiralis, Calamus tenuis, Calamus tetradactylus, Calamus viminalis, Calamus walkeri, Calamus yentuensis, Caryota maxima, Caryota mitis, Caryota monostachya, Caryota sympetala, Chuniophoenix nana, Cocos nucifera, Corypha lecomtei, Corypha utan, Guihaia argyrata, Guihaia grossifibrosa, Korthalsia laciniosa, Korthalsia minor, Lanonia acaulis, Lanonia calciphila, Lanonia centralis, Lanonia dasyantha, Lanonia hexasepala, Lanonia magalonii, Licuala atroviridis, Licuala averyanovii, Licuala bachmaensis, Licuala bidoupensis, Licuala bracteata, Licuala cattienensis, Licuala dakrongensis, Licuala ellipsoidalis, Licuala glaberrima, Licuala longiflora, Licuala manglaensis, Licuala paludosa, Licuala radula, Licuala robinsoniana, Licuala spinosa, Licuala taynguyensis, Livistona halongensis, Livistona saribus, Livistona speciosa, Myrialepis paradoxa, Nenga banaensis, Nypa fruticans, Oncosperma tigillarium, Phoenix loureiroi, Phoenix paludosa, Phoenix roebelenii, Pinanga annamensis, Pinanga baviensis, Pinanga cattienensis, Pinanga cupularis, Pinanga declinata, Pinanga humilis, Pinanga kontumensis, Pinanga nuichuensis, Pinanga quadrijuga, Pinanga sylvestris, Plectocomia elongata, Plectocomia pierreana, Plectocomiopsis geminiflora, Plectocomiopsis songthanhensis, Rhapis excelsa, Rhapis kebangensis, Rhapis laosensis, Rhapis micrantha, Rhapis puhuongensis, Rhapis robusta, Rhapis vidalii, Salacca wallichiana, Trachycarpus geminisectus, Wallichia gracilis"
"VNA"	"Acrocomia aculeata, Bactris setulosa, Coccothrinax barbadensis, Cocos nucifera, Dypsis lutescens, Euterpe precatoria, Geonoma pinnatifrons, Ptychosperma macarthurii, Roystonea oleracea"
"VRG"	"NA"
"WAK"	"NA"
"WAL"	"Cocos nucifera, Metroxylon vitiense"
"WAS"	"NA"
"WAU"	"Livistona alfredii, Livistona eastonii, Livistona lorophylla, Livistona nasmophila, Livistona victoriae, Phoenix canariensis, Phoenix dactylifera"
"WDC"	"NA"
"WHM"	"Calamus tenuis, Phoenix acaulis, Phoenix loureiroi, Phoenix sylvestris, Trachycarpus takil, Wallichia oblongifolia"
"WIN"	"Acrocomia aculeata, Adonidia merrillii, Aiphanes minima, Coccothrinax barbadensis, Cocos nucifera, Desmoncus polyacanthos, Euterpe broadwayi, Geonoma pinnatifrons, Geonoma undata, Prestoea acuminata, Pseudophoenix sargentii, Ptychosperma macarthurii, Roystonea oleracea, Syagrus amara"
"WIS"	"NA"
"WSA"	"Phoenix dactylifera"
"WSB"	"NA"
"WVA"	"NA"
"WYO"	"NA"
"XMS"	"Arenga listeri, Cocos nucifera"
"YAK"	"NA"
"YEM"	"Hyphaene reptans, Hyphaene thebaica, Livistona carinensis, Nannorrhops ritchieana, Phoenix caespitosa, Phoenix reclinata"
"YUG"	"NA"
"YUK"	"NA"
"ZAI"	"Borassus aethiopum, Borassus akeassii, Calamus deerratus, Cocos nucifera, Elaeis guineensis, Eremospatha cabrae, Eremospatha cuspidata, Eremospatha haullevilleana, Eremospatha laurentii, Eremospatha macrocarpa, Eremospatha wendlandiana, Hyphaene guineensis, Hyphaene petersiana, Laccosperma acutiflorum, Laccosperma laeve, Laccosperma opacum, Laccosperma robustum, Laccosperma secundiflorum, Oncocalamus macrospathus, Phoenix reclinata, Podococcus barteri, Raphia gentiliana, Raphia hookeri, Raphia laurentii, Raphia longiflora, Raphia matombe, Raphia monbuttorum, Raphia regalis, Raphia rostrata, Raphia ruwenzorica, Raphia sese, Raphia textilis, Raphia vinifera, Sclerosperma mannii, Sclerosperma profizianum, Sclerosperma walkeri"
"ZAM"	"Borassus aethiopum, Calamus deerratus, Eremospatha cuspidata, Hyphaene petersiana, Phoenix reclinata, Raphia farinifera"
"ZIM"	"Borassus aethiopum, Hyphaene petersiana, Phoenix reclinata, Raphia farinifera"
