"Species"	"Status_BS"	"Status_WS"	"Status_BSWS"
"Acanthophoenix crinita"	"NA"	"NA"	"NA___NA"
"Acanthophoenix rousselii"	"NA"	"NA"	"NA___NA"
"Acanthophoenix rubra"	"NA"	"NA"	"NA___NA"
"Acoelorrhaphe wrightii"	"LC"	"LC"	"LC___LC"
"Acrocomia aculeata"	"LC"	"LC"	"LC___LC"
"Acrocomia crispa"	"NA"	"NA"	"NA___NA"
"Acrocomia emensis"	"nonLC"	"nonLC"	"nonLC___nonLC"
"Acrocomia glaucescens"	"nonLC"	"nonLC"	"nonLC___nonLC"
"Acrocomia hassleri"	"LC"	"nonLC"	"LC___nonLC"
"Acrocomia intumescens"	"LC"	"nonLC"	"LC___nonLC"
"Acrocomia media"	"LC"	"LC"	"LC___LC"
"Acrocomia totai"	"LC"	"LC"	"LC___LC"
"Actinokentia divaricata"	"LC"	"LC"	"LC___LC"
"Actinokentia huerlimannii"	"nonLC"	"nonLC"	"nonLC___nonLC"
"Actinorhytis calapparia"	"LC"	"LC"	"LC___LC"
"Adonidia dransfieldii"	"nonLC"	"nonLC"	"nonLC___nonLC"
"Adonidia merrillii"	"LC"	"nonLC"	"LC___nonLC"
"Aiphanes acanthophylla"	"LC"	"LC"	"LC___LC"
"Aiphanes acaulis"	"nonLC"	"nonLC"	"nonLC___nonLC"
"Aiphanes argos"	"nonLC"	"nonLC"	"nonLC___nonLC"
"Aiphanes bicornis"	"nonLC"	"nonLC"	"nonLC___nonLC"
"Aiphanes buenaventurae"	"nonLC"	"nonLC"	"nonLC___nonLC"
"Aiphanes chiribogensis"	"LC"	"nonLC"	"LC___nonLC"
"Aiphanes concinna"	"LC"	"nonLC"	"LC___nonLC"
"Aiphanes deltoidea"	"LC"	"nonLC"	"LC___nonLC"
"Aiphanes duquei"	"nonLC"	"nonLC"	"nonLC___nonLC"
"Aiphanes eggersii"	"nonLC"	"nonLC"	"nonLC___nonLC"
"Aiphanes erinacea"	"LC"	"nonLC"	"LC___nonLC"
"Aiphanes gelatinosa"	"LC"	"nonLC"	"LC___nonLC"
"Aiphanes graminifolia"	"nonLC"	"nonLC"	"nonLC___nonLC"
"Aiphanes grandis"	"nonLC"	"nonLC"	"nonLC___nonLC"
"Aiphanes hirsuta"	"LC"	"LC"	"LC___LC"
"Aiphanes horrida"	"LC"	"LC"	"LC___LC"
"Aiphanes killipii"	"nonLC"	"nonLC"	"nonLC___nonLC"
"Aiphanes leiostachys"	"nonLC"	"nonLC"	"nonLC___nonLC"
"Aiphanes lindeniana"	"LC"	"nonLC"	"LC___nonLC"
"Aiphanes linearis"	"LC"	"nonLC"	"LC___nonLC"
"Aiphanes macroloba"	"LC"	"nonLC"	"LC___nonLC"
"Aiphanes minima"	"LC"	"LC"	"LC___LC"
"Aiphanes multiplex"	"NA"	"NA"	"NA___NA"
"Aiphanes parvifolia"	"nonLC"	"nonLC"	"nonLC___nonLC"
"Aiphanes pilaris"	"nonLC"	"nonLC"	"nonLC___nonLC"
"Aiphanes simplex"	"LC"	"nonLC"	"LC___nonLC"
"Aiphanes spicata"	"nonLC"	"nonLC"	"nonLC___nonLC"
"Aiphanes tricuspidata"	"LC"	"nonLC"	"LC___nonLC"
"Aiphanes truncata"	"nonLC"	"nonLC"	"nonLC___nonLC"
"Aiphanes ulei"	"LC"	"LC"	"LC___LC"
"Aiphanes verrucosa"	"nonLC"	"nonLC"	"nonLC___nonLC"
"Aiphanes weberbaueri"	"LC"	"LC"	"LC___LC"
"Allagoptera arenaria"	"LC"	"LC"	"LC___LC"
"Allagoptera brevicalyx"	"nonLC"	"nonLC"	"nonLC___nonLC"
"Allagoptera campestris"	"LC"	"LC"	"LC___LC"
"Allagoptera caudescens"	"LC"	"LC"	"LC___LC"
"Allagoptera leucocalyx"	"LC"	"LC"	"LC___LC"
"Allagoptera robusta"	"nonLC"	"nonLC"	"nonLC___nonLC"
"Ammandra decasperma"	"LC"	"nonLC"	"LC___nonLC"
"Aphandra natalia"	"LC"	"LC"	"LC___LC"
"Archontophoenix alexandrae"	"LC"	"LC"	"LC___LC"
"Archontophoenix cunninghamiana"	"nonLC"	"nonLC"	"nonLC___nonLC"
"Archontophoenix maxima"	"nonLC"	"nonLC"	"nonLC___nonLC"
"Archontophoenix myolensis"	"nonLC"	"nonLC"	"nonLC___nonLC"
"Archontophoenix purpurea"	"nonLC"	"nonLC"	"nonLC___nonLC"
"Archontophoenix tuckeri"	"LC"	"nonLC"	"LC___nonLC"
"Areca abdulrahmanii"	"nonLC"	"nonLC"	"nonLC___nonLC"
"Areca ahmadii"	"NA"	"NA"	"NA___NA"
"Areca andersonii"	"NA"	"NA"	"NA___NA"
"Areca arundinacea"	"nonLC"	"nonLC"	"nonLC___nonLC"
"Areca bakeri"	"NA"	"NA"	"NA___NA"
"Areca brachypoda"	"NA"	"NA"	"NA___NA"
"Areca caliso"	"nonLC"	"nonLC"	"nonLC___nonLC"
"Areca camarinensis"	"nonLC"	"nonLC"	"nonLC___nonLC"
"Areca catechu"	"LC"	"LC"	"LC___LC"
"Areca chaiana"	"nonLC"	"nonLC"	"nonLC___nonLC"
"Areca churchii"	"nonLC"	"nonLC"	"nonLC___nonLC"
"Areca concinna"	"NA"	"NA"	"NA___NA"
"Areca congesta"	"NA"	"NA"	"NA___NA"
"Areca costulata"	"NA"	"NA"	"NA___NA"
"Areca dayung"	"nonLC"	"nonLC"	"nonLC___nonLC"
"Areca dransfieldii"	"nonLC"	"nonLC"	"nonLC___nonLC"
"Areca furcata"	"LC"	"nonLC"	"LC___nonLC"
"Areca gurita"	"nonLC"	"nonLC"	"nonLC___nonLC"
"Areca hutchinsoniana"	"nonLC"	"nonLC"	"nonLC___nonLC"
"Areca insignis"	"LC"	"nonLC"	"LC___nonLC"
"Areca ipot"	"nonLC"	"nonLC"	"nonLC___nonLC"
"Areca jokowi"	"NA"	"NA"	"NA___NA"
"Areca jugahpunya"	"nonLC"	"nonLC"	"nonLC___nonLC"
"Areca kinabaluensis"	"LC"	"nonLC"	"LC___nonLC"
"Areca klingkangensis"	"NA"	"NA"	"NA___NA"
"Areca laosensis"	"LC"	"nonLC"	"LC___nonLC"
"Areca ledermanniana"	"NA"	"NA"	"NA___NA"
"Areca macrocalyx"	"LC"	"LC"	"LC___LC"
"Areca mandacanii"	"nonLC"	"nonLC"	"nonLC___nonLC"
"Areca minuta"	"LC"	"LC"	"LC___LC"
"Areca mogeana"	"nonLC"	"nonLC"	"nonLC___nonLC"
"Areca montana"	"LC"	"nonLC"	"LC___nonLC"
"Areca novohibernica"	"nonLC"	"nonLC"	"nonLC___nonLC"
"Areca oxycarpa"	"nonLC"	"nonLC"	"nonLC___nonLC"
"Areca parens"	"nonLC"	"nonLC"	"nonLC___nonLC"
"Areca rheophytica"	"nonLC"	"nonLC"	"nonLC___nonLC"
"Areca ridleyana"	"NA"	"NA"	"NA___NA"
"Areca riparia"	"nonLC"	"nonLC"	"nonLC___nonLC"
"Areca songthanhensis"	"nonLC"	"nonLC"	"nonLC___nonLC"
"Areca subacaulis"	"nonLC"	"nonLC"	"nonLC___nonLC"
"Areca triandra"	"LC"	"LC"	"LC___LC"
"Areca triginticollina"	"nonLC"	"nonLC"	"nonLC___nonLC"
"Areca tunku"	"LC"	"nonLC"	"LC___nonLC"
"Areca unipa"	"nonLC"	"nonLC"	"nonLC___nonLC"
"Areca vestiaria"	"LC"	"LC"	"LC___LC"
"Areca vidaliana"	"LC"	"nonLC"	"LC___nonLC"
"Areca whitfordii"	"nonLC"	"nonLC"	"nonLC___nonLC"
"Arenga australasica"	"LC"	"nonLC"	"LC___nonLC"
"Arenga brevipes"	"LC"	"LC"	"LC___LC"
"Arenga caudata"	"LC"	"LC"	"LC___LC"
"Arenga distincta"	"LC"	"nonLC"	"LC___nonLC"
"Arenga engleri"	"NA"	"NA"	"NA___NA"
"Arenga hastata"	"LC"	"LC"	"LC___LC"
"Arenga hookeriana"	"LC"	"nonLC"	"LC___nonLC"
"Arenga listeri"	"nonLC"	"nonLC"	"nonLC___nonLC"
"Arenga longicarpa"	"NA"	"NA"	"NA___NA"
"Arenga longipes"	"NA"	"NA"	"NA___NA"
"Arenga micrantha"	"NA"	"NA"	"NA___NA"
"Arenga microcarpa"	"LC"	"LC"	"LC___LC"
"Arenga mindorensis"	"NA"	"NA"	"NA___NA"
"Arenga obtusifolia"	"LC"	"nonLC"	"LC___nonLC"
"Arenga pinnata"	"LC"	"LC"	"LC___LC"
"Arenga plicata"	"nonLC"	"nonLC"	"nonLC___nonLC"
"Arenga porphyrocarpa"	"NA"	"NA"	"NA___NA"
"Arenga retroflorescens"	"nonLC"	"nonLC"	"nonLC___nonLC"
"Arenga ryukyuensis"	"nonLC"	"nonLC"	"nonLC___nonLC"
"Arenga talamauensis"	"nonLC"	"nonLC"	"nonLC___nonLC"
"Arenga tremula"	"LC"	"nonLC"	"LC___nonLC"
"Arenga undulatifolia"	"LC"	"LC"	"LC___LC"
"Arenga westerhoutii"	"LC"	"LC"	"LC___LC"
"Arenga wightii"	"nonLC"	"nonLC"	"nonLC___nonLC"
"Asterogyne guianensis"	"NA"	"NA"	"NA___NA"
"Asterogyne martiana"	"LC"	"LC"	"LC___LC"
"Asterogyne ramosa"	"NA"	"NA"	"NA___NA"
"Asterogyne spicata"	"nonLC"	"nonLC"	"nonLC___nonLC"
"Asterogyne yaracuyense"	"nonLC"	"nonLC"	"nonLC___nonLC"
"Astrocaryum acaule"	"LC"	"LC"	"LC___LC"
"Astrocaryum aculeatissimum"	"LC"	"LC"	"LC___LC"
"Astrocaryum aculeatum"	"NA"	"NA"	"NA___NA"
"Astrocaryum alatum"	"LC"	"LC"	"LC___LC"
"Astrocaryum arenarium"	"NA"	"NA"	"NA___NA"
"Astrocaryum campestre"	"LC"	"LC"	"LC___LC"
"Astrocaryum carnosum"	"nonLC"	"nonLC"	"nonLC___nonLC"
"Astrocaryum chambira"	"LC"	"LC"	"LC___LC"
"Astrocaryum chonta"	"LC"	"nonLC"	"LC___nonLC"
"Astrocaryum ciliatum"	"LC"	"nonLC"	"LC___nonLC"
"Astrocaryum confertum"	"NA"	"NA"	"NA___NA"
"Astrocaryum echinatum"	"nonLC"	"nonLC"	"nonLC___nonLC"
"Astrocaryum faranae"	"LC"	"nonLC"	"LC___nonLC"
"Astrocaryum farinosum"	"LC"	"nonLC"	"LC___nonLC"
"Astrocaryum ferrugineum"	"NA"	"NA"	"NA___NA"
"Astrocaryum giganteum"	"NA"	"NA"	"NA___NA"
"Astrocaryum gratum"	"LC"	"nonLC"	"LC___nonLC"
"Astrocaryum huaimi"	"LC"	"LC"	"LC___LC"
"Astrocaryum huicungo"	"NA"	"NA"	"NA___NA"
"Astrocaryum jauari"	"LC"	"LC"	"LC___LC"
"Astrocaryum javarense"	"LC"	"nonLC"	"LC___nonLC"
"Astrocaryum macrocalyx"	"LC"	"LC"	"LC___LC"
"Astrocaryum malybo"	"LC"	"nonLC"	"LC___nonLC"
"Astrocaryum mexicanum"	"LC"	"LC"	"LC___LC"
"Astrocaryum minus"	"NA"	"NA"	"NA___NA"
"Astrocaryum murumuru"	"LC"	"LC"	"LC___LC"
"Astrocaryum paramaca"	"LC"	"nonLC"	"LC___nonLC"
"Astrocaryum perangustatum"	"nonLC"	"nonLC"	"nonLC___nonLC"
"Astrocaryum rodriguesii"	"LC"	"nonLC"	"LC___nonLC"
"Astrocaryum sciophilum"	"LC"	"nonLC"	"LC___nonLC"
"Astrocaryum scopatum"	"nonLC"	"nonLC"	"nonLC___nonLC"
"Astrocaryum sociale"	"nonLC"	"nonLC"	"nonLC___nonLC"
"Astrocaryum standleyanum"	"LC"	"LC"	"LC___LC"
"Astrocaryum triandrum"	"nonLC"	"nonLC"	"nonLC___nonLC"
"Astrocaryum tucuma"	"LC"	"LC"	"LC___LC"
"Astrocaryum ulei"	"LC"	"nonLC"	"LC___nonLC"
"Astrocaryum urostachys"	"LC"	"LC"	"LC___LC"
"Astrocaryum vulgare"	"LC"	"LC"	"LC___LC"
"Attalea allenii"	"LC"	"LC"	"LC___LC"
"Attalea amygdalina"	"nonLC"	"nonLC"	"nonLC___nonLC"
"Attalea amylacea"	"NA"	"NA"	"NA___NA"
"Attalea anisitsiana"	"nonLC"	"nonLC"	"nonLC___nonLC"
"Attalea apoda"	"nonLC"	"nonLC"	"nonLC___nonLC"
"Attalea attaleoides"	"LC"	"nonLC"	"LC___nonLC"
"Attalea barreirensis"	"nonLC"	"nonLC"	"nonLC___nonLC"
"Attalea bassleriana"	"nonLC"	"nonLC"	"nonLC___nonLC"
"Attalea brasiliensis"	"nonLC"	"nonLC"	"nonLC___nonLC"
"Attalea brejinhoensis"	"nonLC"	"nonLC"	"nonLC___nonLC"
"Attalea burretiana"	"LC"	"LC"	"LC___LC"
"Attalea butyracea"	"LC"	"LC"	"LC___LC"
"Attalea camopiensis"	"NA"	"NA"	"NA___NA"
"Attalea cephalotus"	"nonLC"	"nonLC"	"nonLC___nonLC"
"Attalea cohune"	"LC"	"LC"	"LC___LC"
"Attalea colenda"	"LC"	"LC"	"LC___LC"
"Attalea compta"	"nonLC"	"nonLC"	"nonLC___nonLC"
"Attalea crassispatha"	"nonLC"	"nonLC"	"nonLC___nonLC"
"Attalea cuatrecasasiana"	"NA"	"NA"	"NA___NA"
"Attalea dahlgreniana"	"LC"	"nonLC"	"LC___nonLC"
"Attalea degranvillei"	"NA"	"NA"	"NA___NA"
"Attalea dubia"	"LC"	"nonLC"	"LC___nonLC"
"Attalea eichleri"	"LC"	"LC"	"LC___LC"
"Attalea exigua"	"LC"	"LC"	"LC___LC"
"Attalea fairchildensis"	"NA"	"NA"	"NA___NA"
"Attalea funifera"	"LC"	"LC"	"LC___LC"
"Attalea geraensis"	"LC"	"LC"	"LC___LC"
"Attalea guacuyule"	"nonLC"	"nonLC"	"nonLC___nonLC"
"Attalea guianensis"	"NA"	"NA"	"NA___NA"
"Attalea hoehnei"	"NA"	"NA"	"NA___NA"
"Attalea huebneri"	"NA"	"NA"	"NA___NA"
"Attalea humilis"	"LC"	"nonLC"	"LC___nonLC"
"Attalea iguadummat"	"LC"	"nonLC"	"LC___nonLC"
"Attalea insignis"	"LC"	"LC"	"LC___LC"
"Attalea kewensis"	"NA"	"NA"	"NA___NA"
"Attalea lauromuelleriana"	"NA"	"NA"	"NA___NA"
"Attalea luetzelburgii"	"LC"	"nonLC"	"LC___nonLC"
"Attalea macrolepis"	"NA"	"NA"	"NA___NA"
"Attalea magdalenica"	"nonLC"	"nonLC"	"nonLC___nonLC"
"Attalea maracaibensis"	"nonLC"	"nonLC"	"nonLC___nonLC"
"Attalea maripa"	"LC"	"LC"	"LC___LC"
"Attalea maripensis"	"NA"	"NA"	"NA___NA"
"Attalea microcarpa"	"LC"	"LC"	"LC___LC"
"Attalea moorei"	"LC"	"nonLC"	"LC___nonLC"
"Attalea nucifera"	"LC"	"nonLC"	"LC___nonLC"
"Attalea oleifera"	"LC"	"LC"	"LC___LC"
"Attalea osmantha"	"NA"	"NA"	"NA___NA"
"Attalea pacensis"	"NA"	"NA"	"NA___NA"
"Attalea peruviana"	"NA"	"NA"	"NA___NA"
"Attalea phalerata"	"LC"	"LC"	"LC___LC"
"Attalea pindobassu"	"LC"	"nonLC"	"LC___nonLC"
"Attalea plowmanii"	"LC"	"LC"	"LC___LC"
"Attalea princeps"	"LC"	"nonLC"	"LC___nonLC"
"Attalea racemosa"	"LC"	"LC"	"LC___LC"
"Attalea rostrata"	"LC"	"LC"	"LC___LC"
"Attalea salazarii"	"nonLC"	"nonLC"	"nonLC___nonLC"
"Attalea salvadorensis"	"nonLC"	"nonLC"	"nonLC___nonLC"
"Attalea seabrensis"	"LC"	"nonLC"	"LC___nonLC"
"Attalea septuagenata"	"NA"	"NA"	"NA___NA"
"Attalea speciosa"	"LC"	"LC"	"LC___LC"
"Attalea spectabilis"	"LC"	"nonLC"	"LC___nonLC"
"Attalea tessmannii"	"LC"	"LC"	"LC___LC"
"Attalea vitrivir"	"LC"	"nonLC"	"LC___nonLC"
"Attalea weberbaueri"	"nonLC"	"nonLC"	"nonLC___nonLC"
"Attalea wesselsboeri"	"NA"	"NA"	"NA___NA"
"Bactris acanthocarpa"	"LC"	"LC"	"LC___LC"
"Bactris acanthocarpoides"	"LC"	"LC"	"LC___LC"
"Bactris ana-juliae"	"nonLC"	"nonLC"	"nonLC___nonLC"
"Bactris aubletiana"	"NA"	"NA"	"NA___NA"
"Bactris bahiensis"	"LC"	"nonLC"	"LC___nonLC"
"Bactris balanophora"	"LC"	"LC"	"LC___LC"
"Bactris barronis"	"LC"	"LC"	"LC___LC"
"Bactris bidentula"	"LC"	"LC"	"LC___LC"
"Bactris bifida"	"LC"	"LC"	"LC___LC"
"Bactris brongniartii"	"LC"	"LC"	"LC___LC"
"Bactris campestris"	"LC"	"LC"	"LC___LC"
"Bactris caryotifolia"	"LC"	"LC"	"LC___LC"
"Bactris caudata"	"NA"	"NA"	"NA___NA"
"Bactris charnleyae"	"LC"	"nonLC"	"LC___nonLC"
"Bactris chaveziae"	"LC"	"LC"	"LC___LC"
"Bactris chocoensis"	"nonLC"	"nonLC"	"nonLC___nonLC"
"Bactris coloniata"	"LC"	"LC"	"LC___LC"
"Bactris coloradonis"	"LC"	"LC"	"LC___LC"
"Bactris concinna"	"LC"	"LC"	"LC___LC"
"Bactris constanciae"	"LC"	"nonLC"	"LC___nonLC"
"Bactris corossilla"	"LC"	"LC"	"LC___LC"
"Bactris cubensis"	"NA"	"NA"	"NA___NA"
"Bactris cuspidata"	"nonLC"	"nonLC"	"nonLC___nonLC"
"Bactris dianeura"	"LC"	"LC"	"LC___LC"
"Bactris elegans"	"LC"	"LC"	"LC___LC"
"Bactris faucium"	"nonLC"	"nonLC"	"nonLC___nonLC"
"Bactris ferruginea"	"LC"	"LC"	"LC___LC"
"Bactris fissifrons"	"LC"	"LC"	"LC___LC"
"Bactris gasipaes"	"LC"	"LC"	"LC___LC"
"Bactris gastoniana"	"LC"	"nonLC"	"LC___nonLC"
"Bactris glandulosa"	"LC"	"LC"	"LC___LC"
"Bactris glassmanii"	"LC"	"nonLC"	"LC___nonLC"
"Bactris glaucescens"	"LC"	"LC"	"LC___LC"
"Bactris gracilior"	"LC"	"LC"	"LC___LC"
"Bactris grayumii"	"LC"	"nonLC"	"LC___nonLC"
"Bactris guineensis"	"LC"	"LC"	"LC___LC"
"Bactris halmoorei"	"LC"	"LC"	"LC___LC"
"Bactris hatschbachii"	"LC"	"LC"	"LC___LC"
"Bactris herrerana"	"nonLC"	"nonLC"	"nonLC___nonLC"
"Bactris hirta"	"LC"	"LC"	"LC___LC"
"Bactris horridispatha"	"nonLC"	"nonLC"	"nonLC___nonLC"
"Bactris jamaicana"	"NA"	"NA"	"NA___NA"
"Bactris killipii"	"LC"	"LC"	"LC___LC"
"Bactris kunorum"	"nonLC"	"nonLC"	"nonLC___nonLC"
"Bactris longiseta"	"NA"	"NA"	"NA___NA"
"Bactris macroacantha"	"LC"	"LC"	"LC___LC"
"Bactris major"	"LC"	"LC"	"LC___LC"
"Bactris manriquei"	"nonLC"	"nonLC"	"nonLC___nonLC"
"Bactris maraja"	"LC"	"LC"	"LC___LC"
"Bactris martiana"	"LC"	"LC"	"LC___LC"
"Bactris mexicana"	"LC"	"LC"	"LC___LC"
"Bactris militaris"	"LC"	"nonLC"	"LC___nonLC"
"Bactris nancibaensis"	"NA"	"NA"	"NA___NA"
"Bactris obovata"	"NA"	"NA"	"NA___NA"
"Bactris oligocarpa"	"NA"	"NA"	"NA___NA"
"Bactris oligoclada"	"LC"	"nonLC"	"LC___nonLC"
"Bactris panamensis"	"LC"	"nonLC"	"LC___nonLC"
"Bactris pickelii"	"LC"	"LC"	"LC___LC"
"Bactris pilosa"	"LC"	"LC"	"LC___LC"
"Bactris pliniana"	"LC"	"nonLC"	"LC___nonLC"
"Bactris plumeriana"	"LC"	"nonLC"	"LC___nonLC"
"Bactris polystachya"	"nonLC"	"nonLC"	"nonLC___nonLC"
"Bactris ptariana"	"LC"	"nonLC"	"LC___nonLC"
"Bactris rhaphidacantha"	"NA"	"NA"	"NA___NA"
"Bactris riparia"	"LC"	"LC"	"LC___LC"
"Bactris rostrata"	"NA"	"NA"	"NA___NA"
"Bactris schultesii"	"LC"	"LC"	"LC___LC"
"Bactris setiflora"	"nonLC"	"nonLC"	"nonLC___nonLC"
"Bactris setosa"	"LC"	"LC"	"LC___LC"
"Bactris setulosa"	"LC"	"LC"	"LC___LC"
"Bactris simplicifrons"	"LC"	"LC"	"LC___LC"
"Bactris soeiroana"	"nonLC"	"nonLC"	"nonLC___nonLC"
"Bactris sphaerocarpa"	"LC"	"LC"	"LC___LC"
"Bactris syagroides"	"LC"	"nonLC"	"LC___nonLC"
"Bactris tefensis"	"nonLC"	"nonLC"	"nonLC___nonLC"
"Bactris timbuiensis"	"nonLC"	"nonLC"	"nonLC___nonLC"
"Bactris tomentosa"	"LC"	"LC"	"LC___LC"
"Bactris turbinocarpa"	"LC"	"LC"	"LC___LC"
"Bactris vulgaris"	"LC"	"LC"	"LC___LC"
"Balaka diffusa"	"nonLC"	"nonLC"	"nonLC___nonLC"
"Balaka insularis"	"NA"	"NA"	"NA___NA"
"Balaka longirostris"	"LC"	"LC"	"LC___LC"
"Balaka macrocarpa"	"nonLC"	"nonLC"	"nonLC___nonLC"
"Balaka microcarpa"	"nonLC"	"nonLC"	"nonLC___nonLC"
"Balaka pauciflora"	"NA"	"NA"	"NA___NA"
"Balaka samoensis"	"nonLC"	"nonLC"	"nonLC___nonLC"
"Balaka seemannii"	"LC"	"LC"	"LC___LC"
"Balaka streptostachys"	"nonLC"	"nonLC"	"nonLC___nonLC"
"Balaka tahitensis"	"NA"	"NA"	"NA___NA"
"Barcella odora"	"LC"	"nonLC"	"LC___nonLC"
"Basselinia deplanchei"	"nonLC"	"nonLC"	"nonLC___nonLC"
"Basselinia eriostachys"	"LC"	"LC"	"LC___LC"
"Basselinia favieri"	"nonLC"	"nonLC"	"nonLC___nonLC"
"Basselinia glabrata"	"nonLC"	"nonLC"	"nonLC___nonLC"
"Basselinia gracilis"	"nonLC"	"nonLC"	"nonLC___nonLC"
"Basselinia humboldtiana"	"nonLC"	"nonLC"	"nonLC___nonLC"
"Basselinia iterata"	"nonLC"	"nonLC"	"nonLC___nonLC"
"Basselinia moorei"	"nonLC"	"nonLC"	"nonLC___nonLC"
"Basselinia pancheri"	"LC"	"LC"	"LC___LC"
"Basselinia porphyrea"	"nonLC"	"nonLC"	"nonLC___nonLC"
"Basselinia sordida"	"LC"	"LC"	"LC___LC"
"Basselinia tomentosa"	"nonLC"	"nonLC"	"nonLC___nonLC"
"Basselinia velutina"	"nonLC"	"nonLC"	"nonLC___nonLC"
"Basselinia vestita"	"nonLC"	"nonLC"	"nonLC___nonLC"
"Beccariophoenix alfredii"	"nonLC"	"nonLC"	"nonLC___nonLC"
"Beccariophoenix fenestralis"	"nonLC"	"nonLC"	"nonLC___nonLC"
"Beccariophoenix madagascariensis"	"nonLC"	"nonLC"	"nonLC___nonLC"
"Bentinckia condapanna"	"NA"	"NA"	"NA___NA"
"Bentinckia nicobarica"	"NA"	"NA"	"NA___NA"
"Bismarckia nobilis"	"LC"	"LC"	"LC___LC"
"Borassodendron borneense"	"LC"	"nonLC"	"LC___nonLC"
"Borassodendron machadonis"	"LC"	"nonLC"	"LC___nonLC"
"Borassus aethiopum"	"LC"	"LC"	"LC___LC"
"Borassus akeassii"	"LC"	"LC"	"LC___LC"
"Borassus flabellifer"	"LC"	"LC"	"LC___LC"
"Borassus heineanus"	"LC"	"nonLC"	"LC___nonLC"
"Borassus madagascariensis"	"nonLC"	"nonLC"	"nonLC___nonLC"
"Brahea aculeata"	"nonLC"	"nonLC"	"nonLC___nonLC"
"Brahea armata"	"LC"	"LC"	"LC___LC"
"Brahea brandegeei"	"LC"	"LC"	"LC___LC"
"Brahea calcarea"	"LC"	"LC"	"LC___LC"
"Brahea decumbens"	"LC"	"LC"	"LC___LC"
"Brahea dulcis"	"nonLC"	"nonLC"	"nonLC___nonLC"
"Brahea edulis"	"nonLC"	"nonLC"	"nonLC___nonLC"
"Brahea moorei"	"LC"	"LC"	"LC___LC"
"Brahea pimo"	"LC"	"nonLC"	"LC___nonLC"
"Brahea salvadorensis"	"NA"	"NA"	"NA___NA"
"Brahea sarukhanii"	"nonLC"	"nonLC"	"nonLC___nonLC"
"Brassiophoenix drymophloeoides"	"nonLC"	"nonLC"	"nonLC___nonLC"
"Brassiophoenix schumannii"	"LC"	"nonLC"	"LC___nonLC"
"Burretiokentia dumasii"	"nonLC"	"nonLC"	"nonLC___nonLC"
"Burretiokentia grandiflora"	"nonLC"	"nonLC"	"nonLC___nonLC"
"Burretiokentia hapala"	"nonLC"	"nonLC"	"nonLC___nonLC"
"Burretiokentia koghiensis"	"nonLC"	"nonLC"	"nonLC___nonLC"
"Burretiokentia vieillardii"	"LC"	"LC"	"LC___LC"
"Butia archeri"	"LC"	"LC"	"LC___LC"
"Butia arenicola"	"NA"	"NA"	"NA___NA"
"Butia campicola"	"LC"	"nonLC"	"LC___nonLC"
"Butia capitata"	"nonLC"	"nonLC"	"nonLC___nonLC"
"Butia catarinensis"	"LC"	"nonLC"	"LC___nonLC"
"Butia eriospatha"	"nonLC"	"nonLC"	"nonLC___nonLC"
"Butia exilata"	"NA"	"NA"	"NA___NA"
"Butia exospadix"	"LC"	"nonLC"	"LC___nonLC"
"Butia lallemantii"	"nonLC"	"nonLC"	"nonLC___nonLC"
"Butia lepidotispatha"	"NA"	"NA"	"NA___NA"
"Butia leptospatha"	"LC"	"nonLC"	"LC___nonLC"
"Butia marmorii"	"nonLC"	"nonLC"	"nonLC___nonLC"
"Butia matogrossensis"	"nonLC"	"nonLC"	"nonLC___nonLC"
"Butia microspadix"	"nonLC"	"nonLC"	"nonLC___nonLC"
"Butia noblickii"	"nonLC"	"nonLC"	"nonLC___nonLC"
"Butia odorata"	"LC"	"LC"	"LC___LC"
"Butia paraguayensis"	"LC"	"LC"	"LC___LC"
"Butia poni"	"NA"	"NA"	"NA___NA"
"Butia pubispatha"	"NA"	"NA"	"NA___NA"
"Butia purpurascens"	"nonLC"	"nonLC"	"nonLC___nonLC"
"Butia witeckii"	"LC"	"nonLC"	"LC___nonLC"
"Butia yatay"	"LC"	"LC"	"LC___LC"
"Calamus acamptostachys"	"nonLC"	"nonLC"	"nonLC___nonLC"
"Calamus acanthochlamys"	"nonLC"	"nonLC"	"nonLC___nonLC"
"Calamus acanthophyllus"	"nonLC"	"nonLC"	"nonLC___nonLC"
"Calamus acanthospathus"	"LC"	"LC"	"LC___LC"
"Calamus acaulis"	"nonLC"	"nonLC"	"nonLC___nonLC"
"Calamus acehensis"	"NA"	"NA"	"NA___NA"
"Calamus adspersus"	"NA"	"NA"	"NA___NA"
"Calamus affinis"	"nonLC"	"nonLC"	"nonLC___nonLC"
"Calamus aidae"	"NA"	"NA"	"NA___NA"
"Calamus albidus"	"nonLC"	"nonLC"	"nonLC___nonLC"
"Calamus albus"	"NA"	"NA"	"NA___NA"
"Calamus altiscandens"	"nonLC"	"nonLC"	"nonLC___nonLC"
"Calamus andamanicus"	"NA"	"NA"	"NA___NA"
"Calamus angustifolius"	"LC"	"nonLC"	"LC___nonLC"
"Calamus anomalus"	"nonLC"	"nonLC"	"nonLC___nonLC"
"Calamus arborescens"	"LC"	"nonLC"	"LC___nonLC"
"Calamus aruensis"	"LC"	"LC"	"LC___LC"
"Calamus arugda"	"NA"	"NA"	"NA___NA"
"Calamus ashtonii"	"nonLC"	"nonLC"	"nonLC___nonLC"
"Calamus asperrimus"	"LC"	"nonLC"	"LC___nonLC"
"Calamus asteracanthus"	"nonLC"	"nonLC"	"nonLC___nonLC"
"Calamus ater"	"LC"	"nonLC"	"LC___nonLC"
"Calamus australis"	"LC"	"LC"	"LC___LC"
"Calamus axillaris"	"LC"	"LC"	"LC___LC"
"Calamus bachmaensis"	"nonLC"	"nonLC"	"nonLC___nonLC"
"Calamus bacularis"	"LC"	"nonLC"	"LC___nonLC"
"Calamus badius"	"NA"	"NA"	"NA___NA"
"Calamus baiyerensis"	"nonLC"	"nonLC"	"nonLC___nonLC"
"Calamus balerensis"	"nonLC"	"nonLC"	"nonLC___nonLC"
"Calamus balingensis"	"LC"	"nonLC"	"LC___nonLC"
"Calamus banggiensis"	"nonLC"	"nonLC"	"nonLC___nonLC"
"Calamus bankae"	"nonLC"	"nonLC"	"nonLC___nonLC"
"Calamus baratangensis"	"NA"	"NA"	"NA___NA"
"Calamus barbatus"	"nonLC"	"nonLC"	"nonLC___nonLC"
"Calamus barfodii"	"nonLC"	"nonLC"	"nonLC___nonLC"
"Calamus batanensis"	"nonLC"	"nonLC"	"nonLC___nonLC"
"Calamus beccarii"	"LC"	"LC"	"LC___LC"
"Calamus beguinii"	"nonLC"	"nonLC"	"nonLC___nonLC"
"Calamus bicolor"	"NA"	"NA"	"NA___NA"
"Calamus billitonensis"	"NA"	"NA"	"NA___NA"
"Calamus bimanifer"	"NA"	"NA"	"NA___NA"
"Calamus binnendijkii"	"NA"	"NA"	"NA___NA"
"Calamus boniensis"	"NA"	"NA"	"NA___NA"
"Calamus bousigonii"	"LC"	"LC"	"LC___LC"
"Calamus brachypodus"	"LC"	"nonLC"	"LC___nonLC"
"Calamus brandisii"	"NA"	"NA"	"NA___NA"
"Calamus brevicaulis"	"nonLC"	"nonLC"	"nonLC___nonLC"
"Calamus bulubabi"	"nonLC"	"nonLC"	"nonLC___nonLC"
"Calamus burckianus"	"NA"	"NA"	"NA___NA"
"Calamus burkillianus"	"NA"	"NA"	"NA___NA"
"Calamus caesius"	"LC"	"LC"	"LC___LC"
"Calamus calapparius"	"LC"	"nonLC"	"LC___nonLC"
"Calamus calicarpus"	"LC"	"nonLC"	"LC___nonLC"
"Calamus calospathus"	"nonLC"	"nonLC"	"nonLC___nonLC"
"Calamus capillosus"	"nonLC"	"nonLC"	"nonLC___nonLC"
"Calamus caryotoides"	"LC"	"LC"	"LC___LC"
"Calamus castaneus"	"LC"	"LC"	"LC___LC"
"Calamus cawa"	"NA"	"NA"	"NA___NA"
"Calamus centralis"	"nonLC"	"nonLC"	"nonLC___nonLC"
"Calamus ceratophorus"	"nonLC"	"nonLC"	"nonLC___nonLC"
"Calamus cheirophyllus"	"nonLC"	"nonLC"	"nonLC___nonLC"
"Calamus ciliaris"	"NA"	"NA"	"NA___NA"
"Calamus clemensianus"	"NA"	"NA"	"NA___NA"
"Calamus cockburnii"	"NA"	"NA"	"NA___NA"
"Calamus collarifer"	"LC"	"nonLC"	"LC___nonLC"
"Calamus compsostachys"	"nonLC"	"nonLC"	"nonLC___nonLC"
"Calamus comptus"	"LC"	"nonLC"	"LC___nonLC"
"Calamus concinnus"	"LC"	"nonLC"	"LC___nonLC"
"Calamus concolor"	"LC"	"LC"	"LC___LC"
"Calamus confusus"	"NA"	"NA"	"NA___NA"
"Calamus conirostris"	"LC"	"LC"	"LC___LC"
"Calamus conjugatus"	"nonLC"	"nonLC"	"nonLC___nonLC"
"Calamus conspectus"	"nonLC"	"nonLC"	"nonLC___nonLC"
"Calamus convallium"	"LC"	"nonLC"	"LC___nonLC"
"Calamus corneri"	"NA"	"NA"	"NA___NA"
"Calamus crassifolius"	"nonLC"	"nonLC"	"nonLC___nonLC"
"Calamus crinitus"	"NA"	"NA"	"NA___NA"
"Calamus cristatus"	"LC"	"nonLC"	"LC___nonLC"
"Calamus croftii"	"nonLC"	"nonLC"	"nonLC___nonLC"
"Calamus cumingianus"	"NA"	"NA"	"NA___NA"
"Calamus curranii"	"nonLC"	"nonLC"	"nonLC___nonLC"
"Calamus cuthbertsonii"	"LC"	"nonLC"	"LC___nonLC"
"Calamus daemonoropoides"	"NA"	"NA"	"NA___NA"
"Calamus dasyacanthus"	"nonLC"	"nonLC"	"nonLC___nonLC"
"Calamus deerratus"	"LC"	"LC"	"LC___LC"
"Calamus delicatulus"	"NA"	"NA"	"NA___NA"
"Calamus densiflorus"	"nonLC"	"nonLC"	"nonLC___nonLC"
"Calamus depauperatus"	"LC"	"nonLC"	"LC___nonLC"
"Calamus depressiusculus"	"LC"	"nonLC"	"LC___nonLC"
"Calamus dianbaiensis"	"nonLC"	"nonLC"	"nonLC___nonLC"
"Calamus didymocarpus"	"nonLC"	"nonLC"	"nonLC___nonLC"
"Calamus didymophyllus"	"LC"	"LC"	"LC___LC"
"Calamus diepenhorstii"	"LC"	"LC"	"LC___LC"
"Calamus digitatus"	"NA"	"NA"	"NA___NA"
"Calamus dilaceratus"	"NA"	"NA"	"NA___NA"
"Calamus dioicus"	"LC"	"nonLC"	"LC___nonLC"
"Calamus discolor"	"nonLC"	"nonLC"	"nonLC___nonLC"
"Calamus distentus"	"nonLC"	"nonLC"	"nonLC___nonLC"
"Calamus divaricatus"	"LC"	"nonLC"	"LC___nonLC"
"Calamus dongnaiensis"	"nonLC"	"nonLC"	"nonLC___nonLC"
"Calamus draco"	"LC"	"nonLC"	"LC___nonLC"
"Calamus dracunculus"	"NA"	"NA"	"NA___NA"
"Calamus dumetosus"	"nonLC"	"nonLC"	"nonLC___nonLC"
"Calamus egregius"	"nonLC"	"nonLC"	"nonLC___nonLC"
"Calamus elongatus"	"LC"	"nonLC"	"LC___nonLC"
"Calamus equestris"	"NA"	"NA"	"NA___NA"
"Calamus erectus"	"LC"	"LC"	"LC___LC"
"Calamus erinaceus"	"LC"	"LC"	"LC___LC"
"Calamus erioacanthus"	"LC"	"LC"	"LC___LC"
"Calamus erythrocarpus"	"nonLC"	"nonLC"	"nonLC___nonLC"
"Calamus essigii"	"nonLC"	"nonLC"	"nonLC___nonLC"
"Calamus eugenei"	"LC"	"nonLC"	"LC___nonLC"
"Calamus evansii"	"NA"	"NA"	"NA___NA"
"Calamus exilis"	"LC"	"LC"	"LC___LC"
"Calamus fertilis"	"LC"	"nonLC"	"LC___nonLC"
"Calamus filipendulus"	"NA"	"NA"	"NA___NA"
"Calamus filispadix"	"nonLC"	"nonLC"	"nonLC___nonLC"
"Calamus fissilis"	"nonLC"	"nonLC"	"nonLC___nonLC"
"Calamus fissus"	"LC"	"LC"	"LC___LC"
"Calamus flabellatus"	"LC"	"LC"	"LC___LC"
"Calamus flagellum"	"LC"	"LC"	"LC___LC"
"Calamus flexilis"	"nonLC"	"nonLC"	"nonLC___nonLC"
"Calamus floribundus"	"LC"	"nonLC"	"LC___nonLC"
"Calamus forbesii"	"NA"	"NA"	"NA___NA"
"Calamus formicarius"	"LC"	"nonLC"	"LC___nonLC"
"Calamus formosanus"	"LC"	"LC"	"LC___LC"
"Calamus foxworthyi"	"NA"	"NA"	"NA___NA"
"Calamus gamblei"	"NA"	"NA"	"NA___NA"
"Calamus geniculatus"	"LC"	"LC"	"LC___LC"
"Calamus georgei"	"NA"	"NA"	"NA___NA"
"Calamus gibbsianus"	"nonLC"	"nonLC"	"nonLC___nonLC"
"Calamus glaucescens"	"NA"	"NA"	"NA___NA"
"Calamus godefroyi"	"nonLC"	"nonLC"	"nonLC___nonLC"
"Calamus gonospermus"	"LC"	"nonLC"	"LC___nonLC"
"Calamus gracilipes"	"nonLC"	"nonLC"	"nonLC___nonLC"
"Calamus gracilis"	"NA"	"NA"	"NA___NA"
"Calamus grandifolius"	"NA"	"NA"	"NA___NA"
"Calamus grandis"	"LC"	"nonLC"	"LC___nonLC"
"Calamus griseus"	"NA"	"NA"	"NA___NA"
"Calamus guruba"	"LC"	"LC"	"LC___LC"
"Calamus hallierianus"	"LC"	"nonLC"	"LC___nonLC"
"Calamus halmaherensis"	"NA"	"NA"	"NA___NA"
"Calamus harmandii"	"nonLC"	"nonLC"	"nonLC___nonLC"
"Calamus heatubunii"	"nonLC"	"nonLC"	"nonLC___nonLC"
"Calamus helferianus"	"nonLC"	"nonLC"	"nonLC___nonLC"
"Calamus henryanus"	"LC"	"LC"	"LC___LC"
"Calamus heteracanthus"	"LC"	"LC"	"LC___LC"
"Calamus heteroideus"	"NA"	"NA"	"NA___NA"
"Calamus hirsutus"	"LC"	"LC"	"LC___LC"
"Calamus holttumii"	"NA"	"NA"	"NA___NA"
"Calamus hookerianus"	"NA"	"NA"	"NA___NA"
"Calamus horridus"	"NA"	"NA"	"NA___NA"
"Calamus hukaungensis"	"nonLC"	"nonLC"	"nonLC___nonLC"
"Calamus inermis"	"nonLC"	"nonLC"	"nonLC___nonLC"
"Calamus ingens"	"LC"	"nonLC"	"LC___nonLC"
"Calamus inops"	"NA"	"NA"	"NA___NA"
"Calamus insignis"	"LC"	"nonLC"	"LC___nonLC"
"Calamus interruptus"	"nonLC"	"nonLC"	"nonLC___nonLC"
"Calamus jacobsii"	"nonLC"	"nonLC"	"nonLC___nonLC"
"Calamus javensis"	"LC"	"LC"	"LC___LC"
"Calamus jenkinsianus"	"LC"	"LC"	"LC___LC"
"Calamus jenningsianus"	"nonLC"	"nonLC"	"nonLC___nonLC"
"Calamus johndransfieldii"	"NA"	"NA"	"NA___NA"
"Calamus johnsii"	"LC"	"nonLC"	"LC___nonLC"
"Calamus kampucheaensis"	"nonLC"	"nonLC"	"nonLC___nonLC"
"Calamus kandariensis"	"NA"	"NA"	"NA___NA"
"Calamus karnatakensis"	"NA"	"NA"	"NA___NA"
"Calamus karuensis"	"nonLC"	"nonLC"	"nonLC___nonLC"
"Calamus katikii"	"nonLC"	"nonLC"	"nonLC___nonLC"
"Calamus kebariensis"	"NA"	"NA"	"NA___NA"
"Calamus kiahii"	"nonLC"	"nonLC"	"nonLC___nonLC"
"Calamus kingianus"	"nonLC"	"nonLC"	"nonLC___nonLC"
"Calamus kjellbergii"	"NA"	"NA"	"NA___NA"
"Calamus klossii"	"LC"	"nonLC"	"LC___nonLC"
"Calamus komsaryi"	"NA"	"NA"	"NA___NA"
"Calamus kontumensis"	"nonLC"	"nonLC"	"nonLC___nonLC"
"Calamus koordersianus"	"NA"	"NA"	"NA___NA"
"Calamus korthalsii"	"LC"	"LC"	"LC___LC"
"Calamus kostermansii"	"nonLC"	"nonLC"	"nonLC___nonLC"
"Calamus kunstleri"	"LC"	"nonLC"	"LC___nonLC"
"Calamus kurzianus"	"nonLC"	"nonLC"	"nonLC___nonLC"
"Calamus lakshmanae"	"NA"	"NA"	"NA___NA"
"Calamus lambirensis"	"nonLC"	"nonLC"	"nonLC___nonLC"
"Calamus lamprolepis"	"NA"	"NA"	"NA___NA"
"Calamus laoensis"	"nonLC"	"nonLC"	"nonLC___nonLC"
"Calamus lateralis"	"nonLC"	"nonLC"	"nonLC___nonLC"
"Calamus latifolius"	"LC"	"LC"	"LC___LC"
"Calamus lauterbachii"	"LC"	"LC"	"LC___LC"
"Calamus laxissimus"	"NA"	"NA"	"NA___NA"
"Calamus leiocaulis"	"NA"	"NA"	"NA___NA"
"Calamus leloi"	"LC"	"nonLC"	"LC___nonLC"
"Calamus leptopus"	"NA"	"NA"	"NA___NA"
"Calamus leptospadix"	"LC"	"nonLC"	"LC___nonLC"
"Calamus leptostachys"	"NA"	"NA"	"NA___NA"
"Calamus lewisianus"	"LC"	"nonLC"	"LC___nonLC"
"Calamus lobbianus"	"LC"	"LC"	"LC___LC"
"Calamus loherianus"	"nonLC"	"nonLC"	"nonLC___nonLC"
"Calamus longibracteatus"	"nonLC"	"nonLC"	"nonLC___nonLC"
"Calamus longipes"	"LC"	"LC"	"LC___LC"
"Calamus longipinna"	"LC"	"LC"	"LC___LC"
"Calamus longisetus"	"LC"	"LC"	"LC___LC"
"Calamus longispatha"	"NA"	"NA"	"NA___NA"
"Calamus longispinosus"	"NA"	"NA"	"NA___NA"
"Calamus longistipes"	"LC"	"nonLC"	"LC___nonLC"
"Calamus lucysmithiae"	"nonLC"	"nonLC"	"nonLC___nonLC"
"Calamus luteus"	"NA"	"NA"	"NA___NA"
"Calamus macrochlamys"	"LC"	"LC"	"LC___LC"
"Calamus macrophyllus"	"NA"	"NA"	"NA___NA"
"Calamus macropterus"	"nonLC"	"nonLC"	"nonLC___nonLC"
"Calamus macrorhynchus"	"LC"	"LC"	"LC___LC"
"Calamus macrosphaerion"	"NA"	"NA"	"NA___NA"
"Calamus maculatus"	"LC"	"nonLC"	"LC___nonLC"
"Calamus maiadum"	"nonLC"	"nonLC"	"nonLC___nonLC"
"Calamus malawaliensis"	"NA"	"NA"	"NA___NA"
"Calamus manan"	"LC"	"LC"	"LC___LC"
"Calamus manii"	"NA"	"NA"	"NA___NA"
"Calamus manillensis"	"NA"	"NA"	"NA___NA"
"Calamus marginatus"	"LC"	"LC"	"LC___LC"
"Calamus mattanensis"	"LC"	"nonLC"	"LC___nonLC"
"Calamus maturbongsii"	"nonLC"	"nonLC"	"nonLC___nonLC"
"Calamus megalocarpus"	"NA"	"NA"	"NA___NA"
"Calamus megaphyllus"	"NA"	"NA"	"NA___NA"
"Calamus meghalayensis"	"NA"	"NA"	"NA___NA"
"Calamus melanacanthos"	"LC"	"nonLC"	"LC___nonLC"
"Calamus melanochaetes"	"LC"	"LC"	"LC___LC"
"Calamus melanochrous"	"LC"	"LC"	"LC___LC"
"Calamus melanoloma"	"nonLC"	"nonLC"	"nonLC___nonLC"
"Calamus melanorhynchus"	"NA"	"NA"	"NA___NA"
"Calamus merrillii"	"NA"	"NA"	"NA___NA"
"Calamus metzianus"	"NA"	"NA"	"NA___NA"
"Calamus micracanthus"	"LC"	"LC"	"LC___LC"
"Calamus micranthus"	"LC"	"nonLC"	"LC___nonLC"
"Calamus microsphaerion"	"nonLC"	"nonLC"	"nonLC___nonLC"
"Calamus microstachys"	"LC"	"LC"	"LC___LC"
"Calamus minahassae"	"nonLC"	"nonLC"	"nonLC___nonLC"
"Calamus minor"	"NA"	"NA"	"NA___NA"
"Calamus minutus"	"NA"	"NA"	"NA___NA"
"Calamus mirabilis"	"LC"	"nonLC"	"LC___nonLC"
"Calamus mitis"	"NA"	"NA"	"NA___NA"
"Calamus modestus"	"LC"	"LC"	"LC___LC"
"Calamus mogeae"	"NA"	"NA"	"NA___NA"
"Calamus mogeanus"	"NA"	"NA"	"NA___NA"
"Calamus mollis"	"NA"	"NA"	"NA___NA"
"Calamus mollispinus"	"nonLC"	"nonLC"	"nonLC___nonLC"
"Calamus monticola"	"nonLC"	"nonLC"	"nonLC___nonLC"
"Calamus moorei"	"nonLC"	"nonLC"	"nonLC___nonLC"
"Calamus moorhousei"	"NA"	"NA"	"NA___NA"
"Calamus moseleyanus"	"LC"	"nonLC"	"LC___nonLC"
"Calamus moszkowskianus"	"NA"	"NA"	"NA___NA"
"Calamus moti"	"LC"	"nonLC"	"LC___nonLC"
"Calamus muelleri"	"LC"	"LC"	"LC___LC"
"Calamus multispicatus"	"LC"	"LC"	"LC___LC"
"Calamus muricatus"	"LC"	"nonLC"	"LC___nonLC"
"Calamus myriacanthus"	"LC"	"LC"	"LC___LC"
"Calamus myrianthus"	"LC"	"nonLC"	"LC___nonLC"
"Calamus nagbettai"	"NA"	"NA"	"NA___NA"
"Calamus nanduensis"	"nonLC"	"nonLC"	"nonLC___nonLC"
"Calamus nannostachys"	"nonLC"	"nonLC"	"nonLC___nonLC"
"Calamus nanodendron"	"nonLC"	"nonLC"	"nonLC___nonLC"
"Calamus nematospadix"	"nonLC"	"nonLC"	"nonLC___nonLC"
"Calamus nicobaricus"	"NA"	"NA"	"NA___NA"
"Calamus nicolai"	"NA"	"NA"	"NA___NA"
"Calamus nielsenii"	"nonLC"	"nonLC"	"nonLC___nonLC"
"Calamus niger"	"NA"	"NA"	"NA___NA"
"Calamus nitidus"	"NA"	"NA"	"NA___NA"
"Calamus novae-georgii"	"nonLC"	"nonLC"	"nonLC___nonLC"
"Calamus nuichuaensis"	"nonLC"	"nonLC"	"nonLC___nonLC"
"Calamus oblatus"	"LC"	"nonLC"	"LC___nonLC"
"Calamus oblongus"	"nonLC"	"nonLC"	"nonLC___nonLC"
"Calamus occidentalis"	"NA"	"NA"	"NA___NA"
"Calamus ochrolepis"	"LC"	"nonLC"	"LC___nonLC"
"Calamus ocreatus"	"nonLC"	"nonLC"	"nonLC___nonLC"
"Calamus oligolepis"	"nonLC"	"nonLC"	"nonLC___nonLC"
"Calamus oligophyllus"	"NA"	"NA"	"NA___NA"
"Calamus oligostachys"	"LC"	"nonLC"	"LC___nonLC"
"Calamus optimus"	"LC"	"nonLC"	"LC___nonLC"
"Calamus oresbius"	"LC"	"nonLC"	"LC___nonLC"
"Calamus ornatus"	"LC"	"LC"	"LC___LC"
"Calamus orthostachyus"	"NA"	"NA"	"NA___NA"
"Calamus ovoideus"	"nonLC"	"nonLC"	"nonLC___nonLC"
"Calamus oxleyanus"	"LC"	"LC"	"LC___LC"
"Calamus oxycarpus"	"LC"	"LC"	"LC___LC"
"Calamus oxycoccus"	"LC"	"nonLC"	"LC___nonLC"
"Calamus pachypus"	"LC"	"LC"	"LC___LC"
"Calamus pachyrostris"	"NA"	"NA"	"NA___NA"
"Calamus pachystemonus"	"NA"	"NA"	"NA___NA"
"Calamus padangensis"	"NA"	"NA"	"NA___NA"
"Calamus palembanicus"	"NA"	"NA"	"NA___NA"
"Calamus pandanosmus"	"LC"	"LC"	"LC___LC"
"Calamus pannosus"	"nonLC"	"nonLC"	"nonLC___nonLC"
"Calamus papuanus"	"LC"	"nonLC"	"LC___nonLC"
"Calamus papyraceus"	"nonLC"	"nonLC"	"nonLC___nonLC"
"Calamus parutan"	"NA"	"NA"	"NA___NA"
"Calamus parvifructus"	"NA"	"NA"	"NA___NA"
"Calamus parvulus"	"nonLC"	"nonLC"	"nonLC___nonLC"
"Calamus paspalanthus"	"LC"	"LC"	"LC___LC"
"Calamus paulii"	"nonLC"	"nonLC"	"nonLC___nonLC"
"Calamus pedicellaris"	"nonLC"	"nonLC"	"nonLC___nonLC"
"Calamus pedicellatus"	"NA"	"NA"	"NA___NA"
"Calamus penicillatus"	"nonLC"	"nonLC"	"nonLC___nonLC"
"Calamus perakensis"	"NA"	"NA"	"NA___NA"
"Calamus peregrinus"	"LC"	"nonLC"	"LC___nonLC"
"Calamus periacanthus"	"LC"	"LC"	"LC___LC"
"Calamus pholidostachys"	"nonLC"	"nonLC"	"nonLC___nonLC"
"Calamus pilosellus"	"LC"	"nonLC"	"LC___nonLC"
"Calamus pilosissimus"	"LC"	"nonLC"	"LC___nonLC"
"Calamus pintaudii"	"nonLC"	"nonLC"	"nonLC___nonLC"
"Calamus plagiocyclus"	"NA"	"NA"	"NA___NA"
"Calamus platyspathus"	"LC"	"nonLC"	"LC___nonLC"
"Calamus plicatus"	"LC"	"LC"	"LC___LC"
"Calamus poensis"	"nonLC"	"nonLC"	"nonLC___nonLC"
"Calamus pogonacanthus"	"LC"	"LC"	"LC___LC"
"Calamus pogonotium"	"LC"	"nonLC"	"LC___nonLC"
"Calamus poilanei"	"LC"	"LC"	"LC___LC"
"Calamus politus"	"NA"	"NA"	"NA___NA"
"Calamus polycladus"	"nonLC"	"nonLC"	"nonLC___nonLC"
"Calamus polystachys"	"NA"	"NA"	"NA___NA"
"Calamus pseudoconcolor"	"NA"	"NA"	"NA___NA"
"Calamus pseudotenuis"	"NA"	"NA"	"NA___NA"
"Calamus pseudozebrinus"	"nonLC"	"nonLC"	"nonLC___nonLC"
"Calamus psilocladus"	"nonLC"	"nonLC"	"nonLC___nonLC"
"Calamus pumilus"	"nonLC"	"nonLC"	"nonLC___nonLC"
"Calamus pycnocarpus"	"NA"	"NA"	"NA___NA"
"Calamus pygmaeus"	"nonLC"	"nonLC"	"nonLC___nonLC"
"Calamus quangngaiensis"	"nonLC"	"nonLC"	"nonLC___nonLC"
"Calamus radiatus"	"NA"	"NA"	"NA___NA"
"Calamus radicalis"	"LC"	"nonLC"	"LC___nonLC"
"Calamus radulosus"	"NA"	"NA"	"NA___NA"
"Calamus rarispinosus"	"NA"	"NA"	"NA___NA"
"Calamus reinwardtii"	"NA"	"NA"	"NA___NA"
"Calamus reticulatus"	"nonLC"	"nonLC"	"nonLC___nonLC"
"Calamus retroflexus"	"LC"	"nonLC"	"LC___nonLC"
"Calamus reyesianus"	"nonLC"	"nonLC"	"nonLC___nonLC"
"Calamus rhabdocladus"	"LC"	"LC"	"LC___LC"
"Calamus rheedei"	"NA"	"NA"	"NA___NA"
"Calamus rhomboideus"	"LC"	"LC"	"LC___LC"
"Calamus rhytidomus"	"LC"	"nonLC"	"LC___nonLC"
"Calamus ridleyanus"	"NA"	"NA"	"NA___NA"
"Calamus riedelianus"	"NA"	"NA"	"NA___NA"
"Calamus robinsonianus"	"NA"	"NA"	"NA___NA"
"Calamus rotang"	"NA"	"NA"	"NA___NA"
"Calamus ruber"	"NA"	"NA"	"NA___NA"
"Calamus rudentum"	"LC"	"LC"	"LC___LC"
"Calamus rugosus"	"LC"	"nonLC"	"LC___nonLC"
"Calamus rumphii"	"NA"	"NA"	"NA___NA"
"Calamus ruptilis"	"LC"	"nonLC"	"LC___nonLC"
"Calamus ruvidus"	"nonLC"	"nonLC"	"nonLC___nonLC"
"Calamus sabalensis"	"nonLC"	"nonLC"	"nonLC___nonLC"
"Calamus sabensis"	"LC"	"nonLC"	"LC___nonLC"
"Calamus sabut"	"LC"	"LC"	"LC___LC"
"Calamus salicifolius"	"LC"	"LC"	"LC___LC"
"Calamus samian"	"NA"	"NA"	"NA___NA"
"Calamus sarasinorum"	"NA"	"NA"	"NA___NA"
"Calamus sarawakensis"	"LC"	"nonLC"	"LC___nonLC"
"Calamus sashae"	"NA"	"NA"	"NA___NA"
"Calamus scabridulus"	"LC"	"nonLC"	"LC___nonLC"
"Calamus scabrispathus"	"nonLC"	"nonLC"	"nonLC___nonLC"
"Calamus scapigerus"	"LC"	"LC"	"LC___LC"
"Calamus schistoacanthus"	"nonLC"	"nonLC"	"nonLC___nonLC"
"Calamus schlechteri"	"NA"	"NA"	"NA___NA"
"Calamus schlechterianus"	"LC"	"LC"	"LC___LC"
"Calamus scipionum"	"NA"	"NA"	"NA___NA"
"Calamus scleracanthus"	"nonLC"	"nonLC"	"nonLC___nonLC"
"Calamus sedens"	"nonLC"	"nonLC"	"nonLC___nonLC"
"Calamus sedisspirituum"	"NA"	"NA"	"NA___NA"
"Calamus sekundurensis"	"NA"	"NA"	"NA___NA"
"Calamus senalingensis"	"NA"	"NA"	"NA___NA"
"Calamus sepal"	"LC"	"nonLC"	"LC___nonLC"
"Calamus seriatus"	"nonLC"	"nonLC"	"nonLC___nonLC"
"Calamus serpentinus"	"nonLC"	"nonLC"	"nonLC___nonLC"
"Calamus serrulatus"	"LC"	"nonLC"	"LC___nonLC"
"Calamus siberutensis"	"NA"	"NA"	"NA___NA"
"Calamus simplex"	"NA"	"NA"	"NA___NA"
"Calamus singalanus"	"NA"	"NA"	"NA___NA"
"Calamus siphonospathus"	"LC"	"nonLC"	"LC___nonLC"
"Calamus sordidus"	"LC"	"nonLC"	"LC___nonLC"
"Calamus spanostachys"	"NA"	"NA"	"NA___NA"
"Calamus sparsiflorus"	"LC"	"LC"	"LC___LC"
"Calamus spectatissimus"	"LC"	"nonLC"	"LC___nonLC"
"Calamus spiculifer"	"NA"	"NA"	"NA___NA"
"Calamus spinifolius"	"NA"	"NA"	"NA___NA"
"Calamus spinulinervis"	"nonLC"	"nonLC"	"nonLC___nonLC"
"Calamus spiralis"	"nonLC"	"nonLC"	"nonLC___nonLC"
"Calamus stenophyllus"	"nonLC"	"nonLC"	"nonLC___nonLC"
"Calamus stolonifer"	"NA"	"NA"	"NA___NA"
"Calamus suaveolens"	"NA"	"NA"	"NA___NA"
"Calamus subangulatus"	"LC"	"LC"	"LC___LC"
"Calamus sumbawensis"	"NA"	"NA"	"NA___NA"
"Calamus superciliatus"	"nonLC"	"nonLC"	"nonLC___nonLC"
"Calamus symphysipus"	"nonLC"	"nonLC"	"nonLC___nonLC"
"Calamus takanensis"	"NA"	"NA"	"NA___NA"
"Calamus tanakadatei"	"NA"	"NA"	"NA___NA"
"Calamus temii"	"nonLC"	"nonLC"	"nonLC___nonLC"
"Calamus tenompokensis"	"nonLC"	"nonLC"	"nonLC___nonLC"
"Calamus tenuis"	"LC"	"LC"	"LC___LC"
"Calamus tetradactyloides"	"nonLC"	"nonLC"	"nonLC___nonLC"
"Calamus tetradactylus"	"LC"	"LC"	"LC___LC"
"Calamus thwaitesii"	"LC"	"nonLC"	"LC___nonLC"
"Calamus thysanolepis"	"nonLC"	"nonLC"	"nonLC___nonLC"
"Calamus timorensis"	"NA"	"NA"	"NA___NA"
"Calamus toli-toliensis"	"NA"	"NA"	"NA___NA"
"Calamus trachycoleus"	"nonLC"	"nonLC"	"nonLC___nonLC"
"Calamus trichrous"	"NA"	"NA"	"NA___NA"
"Calamus tumidus"	"NA"	"NA"	"NA___NA"
"Calamus unifarius"	"NA"	"NA"	"NA___NA"
"Calamus unijugus"	"nonLC"	"nonLC"	"nonLC___nonLC"
"Calamus urdanetanus"	"nonLC"	"nonLC"	"nonLC___nonLC"
"Calamus ursinus"	"LC"	"nonLC"	"LC___nonLC"
"Calamus uschdraweitianus"	"nonLC"	"nonLC"	"nonLC___nonLC"
"Calamus usitatus"	"LC"	"LC"	"LC___LC"
"Calamus validus"	"NA"	"NA"	"NA___NA"
"Calamus vattayila"	"NA"	"NA"	"NA___NA"
"Calamus verticillaris"	"LC"	"nonLC"	"LC___nonLC"
"Calamus vestitus"	"LC"	"nonLC"	"LC___nonLC"
"Calamus vidalianus"	"NA"	"NA"	"NA___NA"
"Calamus viminalis"	"LC"	"LC"	"LC___LC"
"Calamus vinosus"	"nonLC"	"nonLC"	"nonLC___nonLC"
"Calamus viridissimus"	"NA"	"NA"	"NA___NA"
"Calamus vitiensis"	"LC"	"LC"	"LC___LC"
"Calamus walkeri"	"LC"	"LC"	"LC___LC"
"Calamus wanggaii"	"nonLC"	"nonLC"	"nonLC___nonLC"
"Calamus warburgii"	"LC"	"LC"	"LC___LC"
"Calamus whitmorei"	"NA"	"NA"	"NA___NA"
"Calamus wightii"	"NA"	"NA"	"NA___NA"
"Calamus womersleyi"	"nonLC"	"nonLC"	"nonLC___nonLC"
"Calamus wrightmyoensis"	"NA"	"NA"	"NA___NA"
"Calamus wuliangshanensis"	"nonLC"	"nonLC"	"nonLC___nonLC"
"Calamus yentuensis"	"nonLC"	"nonLC"	"nonLC___nonLC"
"Calamus zebrinus"	"LC"	"LC"	"LC___LC"
"Calamus zeylanicus"	"nonLC"	"nonLC"	"nonLC___nonLC"
"Calamus zieckii"	"LC"	"nonLC"	"LC___nonLC"
"Calamus zollingeri"	"nonLC"	"nonLC"	"nonLC___nonLC"
"Calamus zonatus"	"LC"	"LC"	"LC___LC"
"Calyptrocalyx albertisianus"	"LC"	"LC"	"LC___LC"
"Calyptrocalyx amoenus"	"NA"	"NA"	"NA___NA"
"Calyptrocalyx arfakianus"	"nonLC"	"nonLC"	"nonLC___nonLC"
"Calyptrocalyx awa"	"nonLC"	"nonLC"	"nonLC___nonLC"
"Calyptrocalyx caudiculatus"	"NA"	"NA"	"NA___NA"
"Calyptrocalyx doxanthus"	"nonLC"	"nonLC"	"nonLC___nonLC"
"Calyptrocalyx elegans"	"nonLC"	"nonLC"	"nonLC___nonLC"
"Calyptrocalyx flabellatus"	"nonLC"	"nonLC"	"nonLC___nonLC"
"Calyptrocalyx forbesii"	"LC"	"nonLC"	"LC___nonLC"
"Calyptrocalyx geonomiformis"	"nonLC"	"nonLC"	"nonLC___nonLC"
"Calyptrocalyx hollrungii"	"LC"	"nonLC"	"LC___nonLC"
"Calyptrocalyx julianettii"	"nonLC"	"nonLC"	"nonLC___nonLC"
"Calyptrocalyx lauterbachianus"	"LC"	"nonLC"	"LC___nonLC"
"Calyptrocalyx laxiflorus"	"nonLC"	"nonLC"	"nonLC___nonLC"
"Calyptrocalyx lepidotus"	"nonLC"	"nonLC"	"nonLC___nonLC"
"Calyptrocalyx leptostachys"	"nonLC"	"nonLC"	"nonLC___nonLC"
"Calyptrocalyx merrillianus"	"nonLC"	"nonLC"	"nonLC___nonLC"
"Calyptrocalyx micholitzii"	"nonLC"	"nonLC"	"nonLC___nonLC"
"Calyptrocalyx multifidus"	"nonLC"	"nonLC"	"nonLC___nonLC"
"Calyptrocalyx pachystachys"	"LC"	"nonLC"	"LC___nonLC"
"Calyptrocalyx pauciflorus"	"NA"	"NA"	"NA___NA"
"Calyptrocalyx polyphyllus"	"nonLC"	"nonLC"	"nonLC___nonLC"
"Calyptrocalyx pusillus"	"nonLC"	"nonLC"	"nonLC___nonLC"
"Calyptrocalyx sessiliflorus"	"LC"	"nonLC"	"LC___nonLC"
"Calyptrocalyx spicatus"	"nonLC"	"nonLC"	"nonLC___nonLC"
"Calyptrocalyx yamutumene"	"NA"	"NA"	"NA___NA"
"Calyptrogyne allenii"	"LC"	"nonLC"	"LC___nonLC"
"Calyptrogyne anomala"	"LC"	"nonLC"	"LC___nonLC"
"Calyptrogyne baudensis"	"nonLC"	"nonLC"	"nonLC___nonLC"
"Calyptrogyne coloradensis"	"nonLC"	"nonLC"	"nonLC___nonLC"
"Calyptrogyne condensata"	"LC"	"nonLC"	"LC___nonLC"
"Calyptrogyne costatifrons"	"LC"	"LC"	"LC___LC"
"Calyptrogyne deneversii"	"nonLC"	"nonLC"	"nonLC___nonLC"
"Calyptrogyne fortunensis"	"nonLC"	"nonLC"	"nonLC___nonLC"
"Calyptrogyne ghiesbreghtiana"	"LC"	"LC"	"LC___LC"
"Calyptrogyne herrerae"	"nonLC"	"nonLC"	"nonLC___nonLC"
"Calyptrogyne kunorum"	"nonLC"	"nonLC"	"nonLC___nonLC"
"Calyptrogyne osensis"	"LC"	"nonLC"	"LC___nonLC"
"Calyptrogyne panamensis"	"LC"	"nonLC"	"LC___nonLC"
"Calyptrogyne pubescens"	"nonLC"	"nonLC"	"nonLC___nonLC"
"Calyptrogyne sanblasensis"	"nonLC"	"nonLC"	"nonLC___nonLC"
"Calyptrogyne trichostachys"	"LC"	"nonLC"	"LC___nonLC"
"Calyptrogyne tutensis"	"nonLC"	"nonLC"	"nonLC___nonLC"
"Calyptronoma occidentalis"	"nonLC"	"nonLC"	"nonLC___nonLC"
"Calyptronoma plumeriana"	"LC"	"nonLC"	"LC___nonLC"
"Calyptronoma rivalis"	"nonLC"	"nonLC"	"nonLC___nonLC"
"Carpentaria acuminata"	"LC"	"LC"	"LC___LC"
"Carpoxylon macrospermum"	"NA"	"NA"	"NA___NA"
"Caryota alberti"	"NA"	"NA"	"NA___NA"
"Caryota angustifolia"	"nonLC"	"nonLC"	"nonLC___nonLC"
"Caryota cumingii"	"LC"	"nonLC"	"LC___nonLC"
"Caryota kiriwongensis"	"nonLC"	"nonLC"	"nonLC___nonLC"
"Caryota maxima"	"LC"	"LC"	"LC___LC"
"Caryota mitis"	"LC"	"LC"	"LC___LC"
"Caryota monostachya"	"LC"	"LC"	"LC___LC"
"Caryota no"	"LC"	"nonLC"	"LC___nonLC"
"Caryota obtusa"	"LC"	"LC"	"LC___LC"
"Caryota ophiopellis"	"NA"	"NA"	"NA___NA"
"Caryota rumphiana"	"LC"	"LC"	"LC___LC"
"Caryota sympetala"	"LC"	"LC"	"LC___LC"
"Caryota urens"	"LC"	"LC"	"LC___LC"
"Caryota zebrina"	"nonLC"	"nonLC"	"nonLC___nonLC"
"Ceroxylon alpinum"	"LC"	"nonLC"	"LC___nonLC"
"Ceroxylon amazonicum"	"nonLC"	"nonLC"	"nonLC___nonLC"
"Ceroxylon ceriferum"	"nonLC"	"nonLC"	"nonLC___nonLC"
"Ceroxylon echinulatum"	"LC"	"nonLC"	"LC___nonLC"
"Ceroxylon parvifrons"	"nonLC"	"nonLC"	"nonLC___nonLC"
"Ceroxylon parvum"	"nonLC"	"nonLC"	"nonLC___nonLC"
"Ceroxylon peruvianum"	"nonLC"	"nonLC"	"nonLC___nonLC"
"Ceroxylon pityrophyllum"	"LC"	"nonLC"	"LC___nonLC"
"Ceroxylon quindiuense"	"LC"	"LC"	"LC___LC"
"Ceroxylon sasaimae"	"nonLC"	"nonLC"	"nonLC___nonLC"
"Ceroxylon ventricosum"	"LC"	"nonLC"	"LC___nonLC"
"Ceroxylon vogelianum"	"LC"	"LC"	"LC___LC"
"Chamaedorea adscendens"	"nonLC"	"nonLC"	"nonLC___nonLC"
"Chamaedorea allenii"	"LC"	"LC"	"LC___LC"
"Chamaedorea alternans"	"LC"	"LC"	"LC___LC"
"Chamaedorea amabilis"	"LC"	"nonLC"	"LC___nonLC"
"Chamaedorea anemophila"	"LC"	"nonLC"	"LC___nonLC"
"Chamaedorea angustisecta"	"LC"	"LC"	"LC___LC"
"Chamaedorea arenbergiana"	"LC"	"LC"	"LC___LC"
"Chamaedorea atrovirens"	"NA"	"NA"	"NA___NA"
"Chamaedorea benziei"	"nonLC"	"nonLC"	"nonLC___nonLC"
"Chamaedorea binderi"	"nonLC"	"nonLC"	"nonLC___nonLC"
"Chamaedorea brachyclada"	"LC"	"nonLC"	"LC___nonLC"
"Chamaedorea brachypoda"	"nonLC"	"nonLC"	"nonLC___nonLC"
"Chamaedorea carchensis"	"LC"	"LC"	"LC___LC"
"Chamaedorea castillo-montii"	"NA"	"NA"	"NA___NA"
"Chamaedorea cataractarum"	"LC"	"LC"	"LC___LC"
"Chamaedorea christinae"	"nonLC"	"nonLC"	"nonLC___nonLC"
"Chamaedorea correae"	"LC"	"nonLC"	"LC___nonLC"
"Chamaedorea costaricana"	"LC"	"LC"	"LC___LC"
"Chamaedorea crucensis"	"LC"	"nonLC"	"LC___nonLC"
"Chamaedorea dammeriana"	"LC"	"LC"	"LC___LC"
"Chamaedorea deckeriana"	"LC"	"LC"	"LC___LC"
"Chamaedorea deneversiana"	"LC"	"LC"	"LC___LC"
"Chamaedorea elatior"	"LC"	"LC"	"LC___LC"
"Chamaedorea elegans"	"LC"	"LC"	"LC___LC"
"Chamaedorea ernesti-augusti"	"NA"	"NA"	"NA___NA"
"Chamaedorea falcifera"	"nonLC"	"nonLC"	"nonLC___nonLC"
"Chamaedorea foveata"	"nonLC"	"nonLC"	"nonLC___nonLC"
"Chamaedorea fractiflexa"	"nonLC"	"nonLC"	"nonLC___nonLC"
"Chamaedorea fragrans"	"nonLC"	"nonLC"	"nonLC___nonLC"
"Chamaedorea frondosa"	"nonLC"	"nonLC"	"nonLC___nonLC"
"Chamaedorea geonomiformis"	"nonLC"	"nonLC"	"nonLC___nonLC"
"Chamaedorea glaucifolia"	"nonLC"	"nonLC"	"nonLC___nonLC"
"Chamaedorea graminifolia"	"nonLC"	"nonLC"	"nonLC___nonLC"
"Chamaedorea guntheriana"	"nonLC"	"nonLC"	"nonLC___nonLC"
"Chamaedorea hodelii"	"nonLC"	"nonLC"	"nonLC___nonLC"
"Chamaedorea hooperiana"	"nonLC"	"nonLC"	"nonLC___nonLC"
"Chamaedorea ibarrae"	"LC"	"LC"	"LC___LC"
"Chamaedorea incrustata"	"nonLC"	"nonLC"	"nonLC___nonLC"
"Chamaedorea keelerorum"	"LC"	"LC"	"LC___LC"
"Chamaedorea klotzschiana"	"nonLC"	"nonLC"	"nonLC___nonLC"
"Chamaedorea lehmannii"	"NA"	"NA"	"NA___NA"
"Chamaedorea liebmannii"	"LC"	"LC"	"LC___LC"
"Chamaedorea linearis"	"LC"	"LC"	"LC___LC"
"Chamaedorea lucidifrons"	"LC"	"LC"	"LC___LC"
"Chamaedorea macrospadix"	"LC"	"LC"	"LC___LC"
"Chamaedorea matae"	"LC"	"nonLC"	"LC___nonLC"
"Chamaedorea metallica"	"nonLC"	"nonLC"	"nonLC___nonLC"
"Chamaedorea microphylla"	"nonLC"	"nonLC"	"nonLC___nonLC"
"Chamaedorea microspadix"	"LC"	"LC"	"LC___LC"
"Chamaedorea moliniana"	"nonLC"	"nonLC"	"nonLC___nonLC"
"Chamaedorea nationsiana"	"NA"	"NA"	"NA___NA"
"Chamaedorea neurochlamys"	"LC"	"LC"	"LC___LC"
"Chamaedorea nubium"	"LC"	"LC"	"LC___LC"
"Chamaedorea oblongata"	"nonLC"	"nonLC"	"nonLC___nonLC"
"Chamaedorea oreophila"	"nonLC"	"nonLC"	"nonLC___nonLC"
"Chamaedorea pachecoana"	"NA"	"NA"	"NA___NA"
"Chamaedorea palmeriana"	"LC"	"nonLC"	"LC___nonLC"
"Chamaedorea parvifolia"	"LC"	"nonLC"	"LC___nonLC"
"Chamaedorea parvisecta"	"nonLC"	"nonLC"	"nonLC___nonLC"
"Chamaedorea pauciflora"	"LC"	"LC"	"LC___LC"
"Chamaedorea pedunculata"	"NA"	"NA"	"NA___NA"
"Chamaedorea pinnatifrons"	"LC"	"LC"	"LC___LC"
"Chamaedorea piscifolia"	"nonLC"	"nonLC"	"nonLC___nonLC"
"Chamaedorea pittieri"	"LC"	"nonLC"	"LC___nonLC"
"Chamaedorea plumosa"	"nonLC"	"nonLC"	"nonLC___nonLC"
"Chamaedorea pochutlensis"	"LC"	"LC"	"LC___LC"
"Chamaedorea ponderosa"	"LC"	"nonLC"	"LC___nonLC"
"Chamaedorea pumila"	"LC"	"LC"	"LC___LC"
"Chamaedorea pygmaea"	"LC"	"LC"	"LC___LC"
"Chamaedorea queroana"	"nonLC"	"nonLC"	"nonLC___nonLC"
"Chamaedorea radicalis"	"LC"	"LC"	"LC___LC"
"Chamaedorea recurvata"	"nonLC"	"nonLC"	"nonLC___nonLC"
"Chamaedorea rhizomatosa"	"NA"	"NA"	"NA___NA"
"Chamaedorea ricardoi"	"nonLC"	"nonLC"	"nonLC___nonLC"
"Chamaedorea rigida"	"NA"	"NA"	"NA___NA"
"Chamaedorea robertii"	"LC"	"nonLC"	"LC___nonLC"
"Chamaedorea rojasiana"	"LC"	"LC"	"LC___LC"
"Chamaedorea rosibeliae"	"nonLC"	"nonLC"	"nonLC___nonLC"
"Chamaedorea rossteniorum"	"LC"	"nonLC"	"LC___nonLC"
"Chamaedorea sartorii"	"LC"	"LC"	"LC___LC"
"Chamaedorea scheryi"	"LC"	"LC"	"LC___LC"
"Chamaedorea schiedeana"	"nonLC"	"nonLC"	"nonLC___nonLC"
"Chamaedorea schippii"	"LC"	"nonLC"	"LC___nonLC"
"Chamaedorea seifrizii"	"LC"	"LC"	"LC___LC"
"Chamaedorea serpens"	"nonLC"	"nonLC"	"nonLC___nonLC"
"Chamaedorea simplex"	"nonLC"	"nonLC"	"nonLC___nonLC"
"Chamaedorea skutchii"	"NA"	"NA"	"NA___NA"
"Chamaedorea smithii"	"nonLC"	"nonLC"	"nonLC___nonLC"
"Chamaedorea stenocarpa"	"LC"	"nonLC"	"LC___nonLC"
"Chamaedorea stolonifera"	"nonLC"	"nonLC"	"nonLC___nonLC"
"Chamaedorea stricta"	"LC"	"nonLC"	"LC___nonLC"
"Chamaedorea subjectifolia"	"LC"	"nonLC"	"LC___nonLC"
"Chamaedorea tenerrima"	"nonLC"	"nonLC"	"nonLC___nonLC"
"Chamaedorea tepejilote"	"LC"	"LC"	"LC___LC"
"Chamaedorea tuerckheimii"	"LC"	"LC"	"LC___LC"
"Chamaedorea undulatifolia"	"LC"	"nonLC"	"LC___nonLC"
"Chamaedorea verapazensis"	"nonLC"	"nonLC"	"nonLC___nonLC"
"Chamaedorea verecunda"	"nonLC"	"nonLC"	"nonLC___nonLC"
"Chamaedorea volcanensis"	"NA"	"NA"	"NA___NA"
"Chamaedorea vulgata"	"nonLC"	"nonLC"	"nonLC___nonLC"
"Chamaedorea warscewiczii"	"LC"	"LC"	"LC___LC"
"Chamaedorea whitelockiana"	"LC"	"nonLC"	"LC___nonLC"
"Chamaedorea woodsoniana"	"LC"	"LC"	"LC___LC"
"Chamaedorea zamorae"	"LC"	"nonLC"	"LC___nonLC"
"Chamaerops humilis"	"LC"	"LC"	"LC___LC"
"Chambeyronia lepidota"	"LC"	"LC"	"LC___LC"
"Chambeyronia macrocarpa"	"LC"	"LC"	"LC___LC"
"Chelyocarpus chuco"	"LC"	"nonLC"	"LC___nonLC"
"Chelyocarpus dianeurus"	"LC"	"nonLC"	"LC___nonLC"
"Chelyocarpus repens"	"LC"	"nonLC"	"LC___nonLC"
"Chelyocarpus ulei"	"LC"	"LC"	"LC___LC"
"Chuniophoenix hainanensis"	"nonLC"	"nonLC"	"nonLC___nonLC"
"Chuniophoenix nana"	"nonLC"	"nonLC"	"nonLC___nonLC"
"Clinosperma bracteale"	"LC"	"LC"	"LC___LC"
"Clinosperma lanuginosa"	"nonLC"	"nonLC"	"nonLC___nonLC"
"Clinosperma macrocarpa"	"nonLC"	"nonLC"	"nonLC___nonLC"
"Clinosperma vaginata"	"nonLC"	"nonLC"	"nonLC___nonLC"
"Clinostigma carolinense"	"NA"	"NA"	"NA___NA"
"Clinostigma collegarum"	"nonLC"	"nonLC"	"nonLC___nonLC"
"Clinostigma exorrhizum"	"LC"	"LC"	"LC___LC"
"Clinostigma gronophyllum"	"nonLC"	"nonLC"	"nonLC___nonLC"
"Clinostigma haerestigma"	"NA"	"NA"	"NA___NA"
"Clinostigma harlandii"	"NA"	"NA"	"NA___NA"
"Clinostigma onchorhynchum"	"NA"	"NA"	"NA___NA"
"Clinostigma ponapense"	"nonLC"	"nonLC"	"nonLC___nonLC"
"Clinostigma samoense"	"NA"	"NA"	"NA___NA"
"Clinostigma savoryanum"	"NA"	"NA"	"NA___NA"
"Clinostigma warburgii"	"NA"	"NA"	"NA___NA"
"Coccothrinax acunana"	"NA"	"NA"	"NA___NA"
"Coccothrinax alexandri"	"NA"	"NA"	"NA___NA"
"Coccothrinax alta"	"LC"	"nonLC"	"LC___nonLC"
"Coccothrinax argentata"	"LC"	"LC"	"LC___LC"
"Coccothrinax argentea"	"LC"	"nonLC"	"LC___nonLC"
"Coccothrinax baracoensis"	"NA"	"NA"	"NA___NA"
"Coccothrinax barbadensis"	"LC"	"LC"	"LC___LC"
"Coccothrinax bermudezii"	"NA"	"NA"	"NA___NA"
"Coccothrinax borhidiana"	"nonLC"	"nonLC"	"nonLC___nonLC"
"Coccothrinax boschiana"	"nonLC"	"nonLC"	"nonLC___nonLC"
"Coccothrinax camagueyana"	"NA"	"NA"	"NA___NA"
"Coccothrinax clarensis"	"NA"	"NA"	"NA___NA"
"Coccothrinax concolor"	"NA"	"NA"	"NA___NA"
"Coccothrinax crinita"	"NA"	"NA"	"NA___NA"
"Coccothrinax cupularis"	"NA"	"NA"	"NA___NA"
"Coccothrinax ekmanii"	"nonLC"	"nonLC"	"nonLC___nonLC"
"Coccothrinax elegans"	"NA"	"NA"	"NA___NA"
"Coccothrinax fagildei"	"NA"	"NA"	"NA___NA"
"Coccothrinax fragrans"	"NA"	"NA"	"NA___NA"
"Coccothrinax garciana"	"NA"	"NA"	"NA___NA"
"Coccothrinax gracilis"	"LC"	"nonLC"	"LC___nonLC"
"Coccothrinax guantanamensis"	"NA"	"NA"	"NA___NA"
"Coccothrinax gundlachii"	"NA"	"NA"	"NA___NA"
"Coccothrinax hioramii"	"nonLC"	"nonLC"	"nonLC___nonLC"
"Coccothrinax inaguensis"	"NA"	"NA"	"NA___NA"
"Coccothrinax jamaicensis"	"nonLC"	"nonLC"	"nonLC___nonLC"
"Coccothrinax jimenezii"	"NA"	"NA"	"NA___NA"
"Coccothrinax leonis"	"NA"	"NA"	"NA___NA"
"Coccothrinax litoralis"	"nonLC"	"nonLC"	"nonLC___nonLC"
"Coccothrinax macroglossa"	"NA"	"NA"	"NA___NA"
"Coccothrinax microphylla"	"NA"	"NA"	"NA___NA"
"Coccothrinax miraguama"	"NA"	"NA"	"NA___NA"
"Coccothrinax moaensis"	"NA"	"NA"	"NA___NA"
"Coccothrinax montana"	"NA"	"NA"	"NA___NA"
"Coccothrinax munizii"	"NA"	"NA"	"NA___NA"
"Coccothrinax muricata"	"NA"	"NA"	"NA___NA"
"Coccothrinax nipensis"	"NA"	"NA"	"NA___NA"
"Coccothrinax orientalis"	"nonLC"	"nonLC"	"nonLC___nonLC"
"Coccothrinax pauciramosa"	"NA"	"NA"	"NA___NA"
"Coccothrinax proctorii"	"nonLC"	"nonLC"	"nonLC___nonLC"
"Coccothrinax pseudorigida"	"NA"	"NA"	"NA___NA"
"Coccothrinax pumila"	"NA"	"NA"	"NA___NA"
"Coccothrinax readii"	"nonLC"	"nonLC"	"nonLC___nonLC"
"Coccothrinax rigida"	"NA"	"NA"	"NA___NA"
"Coccothrinax salvatoris"	"NA"	"NA"	"NA___NA"
"Coccothrinax saxicola"	"NA"	"NA"	"NA___NA"
"Coccothrinax scoparia"	"NA"	"NA"	"NA___NA"
"Coccothrinax spissa"	"LC"	"nonLC"	"LC___nonLC"
"Coccothrinax torrida"	"NA"	"NA"	"NA___NA"
"Coccothrinax trinitensis"	"NA"	"NA"	"NA___NA"
"Coccothrinax victorinii"	"NA"	"NA"	"NA___NA"
"Coccothrinax yunquensis"	"nonLC"	"nonLC"	"nonLC___nonLC"
"Coccothrinax yuraguana"	"nonLC"	"nonLC"	"nonLC___nonLC"
"Cocos nucifera"	"LC"	"LC"	"LC___LC"
"Colpothrinax aphanopetala"	"LC"	"nonLC"	"LC___nonLC"
"Colpothrinax cookii"	"LC"	"nonLC"	"LC___nonLC"
"Colpothrinax wrightii"	"NA"	"NA"	"NA___NA"
"Copernicia alba"	"LC"	"LC"	"LC___LC"
"Copernicia baileyana"	"NA"	"NA"	"NA___NA"
"Copernicia berteroana"	"LC"	"nonLC"	"LC___nonLC"
"Copernicia brittonorum"	"NA"	"NA"	"NA___NA"
"Copernicia cowellii"	"NA"	"NA"	"NA___NA"
"Copernicia curbeloi"	"NA"	"NA"	"NA___NA"
"Copernicia curtissii"	"nonLC"	"nonLC"	"nonLC___nonLC"
"Copernicia ekmanii"	"nonLC"	"nonLC"	"nonLC___nonLC"
"Copernicia fallaensis"	"nonLC"	"nonLC"	"nonLC___nonLC"
"Copernicia gigas"	"NA"	"NA"	"NA___NA"
"Copernicia glabrescens"	"NA"	"NA"	"NA___NA"
"Copernicia hospita"	"NA"	"NA"	"NA___NA"
"Copernicia humicola"	"NA"	"NA"	"NA___NA"
"Copernicia longiglossa"	"NA"	"NA"	"NA___NA"
"Copernicia macroglossa"	"NA"	"NA"	"NA___NA"
"Copernicia molinetii"	"NA"	"NA"	"NA___NA"
"Copernicia oxycalyx"	"NA"	"NA"	"NA___NA"
"Copernicia prunifera"	"LC"	"LC"	"LC___LC"
"Copernicia rigida"	"NA"	"NA"	"NA___NA"
"Copernicia roigii"	"NA"	"NA"	"NA___NA"
"Copernicia tectorum"	"LC"	"LC"	"LC___LC"
"Copernicia yarey"	"nonLC"	"nonLC"	"nonLC___nonLC"
"Corypha lecomtei"	"LC"	"nonLC"	"LC___nonLC"
"Corypha microclada"	"NA"	"NA"	"NA___NA"
"Corypha taliera"	"NA"	"NA"	"NA___NA"
"Corypha umbraculifera"	"NA"	"NA"	"NA___NA"
"Corypha utan"	"LC"	"LC"	"LC___LC"
"Cryosophila bartlettii"	"nonLC"	"nonLC"	"nonLC___nonLC"
"Cryosophila cookii"	"nonLC"	"nonLC"	"nonLC___nonLC"
"Cryosophila grayumii"	"LC"	"nonLC"	"LC___nonLC"
"Cryosophila guagara"	"LC"	"nonLC"	"LC___nonLC"
"Cryosophila kalbreyeri"	"LC"	"LC"	"LC___LC"
"Cryosophila macrocarpa"	"nonLC"	"nonLC"	"nonLC___nonLC"
"Cryosophila nana"	"NA"	"NA"	"NA___NA"
"Cryosophila stauracantha"	"LC"	"LC"	"LC___LC"
"Cryosophila warscewiczii"	"LC"	"LC"	"LC___LC"
"Cryosophila williamsii"	"nonLC"	"nonLC"	"nonLC___nonLC"
"Cyphokentia cerifera"	"nonLC"	"nonLC"	"nonLC___nonLC"
"Cyphokentia macrostachya"	"LC"	"LC"	"LC___LC"
"Cyphophoenix alba"	"LC"	"LC"	"LC___LC"
"Cyphophoenix elegans"	"nonLC"	"nonLC"	"nonLC___nonLC"
"Cyphophoenix fulcita"	"LC"	"LC"	"LC___LC"
"Cyphophoenix nucele"	"nonLC"	"nonLC"	"nonLC___nonLC"
"Cyphosperma balansae"	"LC"	"LC"	"LC___LC"
"Cyphosperma naboutinense"	"nonLC"	"nonLC"	"nonLC___nonLC"
"Cyphosperma tanga"	"nonLC"	"nonLC"	"nonLC___nonLC"
"Cyphosperma trichospadix"	"nonLC"	"nonLC"	"nonLC___nonLC"
"Cyphosperma voutmelense"	"nonLC"	"nonLC"	"nonLC___nonLC"
"Cyrtostachys bakeri"	"nonLC"	"nonLC"	"nonLC___nonLC"
"Cyrtostachys barbata"	"NA"	"NA"	"NA___NA"
"Cyrtostachys elegans"	"nonLC"	"nonLC"	"nonLC___nonLC"
"Cyrtostachys excelsa"	"nonLC"	"nonLC"	"nonLC___nonLC"
"Cyrtostachys glauca"	"LC"	"LC"	"LC___LC"
"Cyrtostachys loriae"	"LC"	"LC"	"LC___LC"
"Cyrtostachys renda"	"LC"	"LC"	"LC___LC"
"Deckenia nobilis"	"nonLC"	"nonLC"	"nonLC___nonLC"
"Desmoncus chinantlensis"	"LC"	"LC"	"LC___LC"
"Desmoncus cirrhifer"	"LC"	"LC"	"LC___LC"
"Desmoncus costaricensis"	"nonLC"	"nonLC"	"nonLC___nonLC"
"Desmoncus giganteus"	"LC"	"LC"	"LC___LC"
"Desmoncus horridus"	"LC"	"LC"	"LC___LC"
"Desmoncus interjectus"	"nonLC"	"nonLC"	"nonLC___nonLC"
"Desmoncus kunarius"	"nonLC"	"nonLC"	"nonLC___nonLC"
"Desmoncus latisectus"	"LC"	"nonLC"	"LC___nonLC"
"Desmoncus leptoclonos"	"LC"	"LC"	"LC___LC"
"Desmoncus loretanus"	"nonLC"	"nonLC"	"nonLC___nonLC"
"Desmoncus madrensis"	"nonLC"	"nonLC"	"nonLC___nonLC"
"Desmoncus mitis"	"LC"	"LC"	"LC___LC"
"Desmoncus moorei"	"LC"	"nonLC"	"LC___nonLC"
"Desmoncus myriacanthos"	"LC"	"LC"	"LC___LC"
"Desmoncus obovoideus"	"nonLC"	"nonLC"	"nonLC___nonLC"
"Desmoncus orthacanthos"	"LC"	"LC"	"LC___LC"
"Desmoncus osensis"	"nonLC"	"nonLC"	"nonLC___nonLC"
"Desmoncus parvulus"	"LC"	"LC"	"LC___LC"
"Desmoncus polyacanthos"	"LC"	"LC"	"LC___LC"
"Desmoncus prunifer"	"nonLC"	"nonLC"	"nonLC___nonLC"
"Desmoncus pumilus"	"LC"	"nonLC"	"LC___nonLC"
"Desmoncus setosus"	"LC"	"nonLC"	"LC___nonLC"
"Desmoncus stans"	"nonLC"	"nonLC"	"nonLC___nonLC"
"Desmoncus vacivus"	"LC"	"LC"	"LC___LC"
"Dictyocaryum fuscum"	"nonLC"	"nonLC"	"nonLC___nonLC"
"Dictyocaryum lamarckianum"	"LC"	"LC"	"LC___LC"
"Dictyocaryum ptarianum"	"LC"	"LC"	"LC___LC"
"Dictyosperma album"	"LC"	"nonLC"	"LC___nonLC"
"Dransfieldia micrantha"	"nonLC"	"nonLC"	"nonLC___nonLC"
"Drymophloeus litigiosus"	"LC"	"nonLC"	"LC___nonLC"
"Drymophloeus oliviformis"	"LC"	"nonLC"	"LC___nonLC"
"Drymophloeus whitmeeanus"	"NA"	"NA"	"NA___NA"
"Dypsis acaulis"	"nonLC"	"nonLC"	"nonLC___nonLC"
"Dypsis acuminum"	"nonLC"	"nonLC"	"nonLC___nonLC"
"Dypsis albofarinosa"	"nonLC"	"nonLC"	"nonLC___nonLC"
"Dypsis ambanjae"	"nonLC"	"nonLC"	"nonLC___nonLC"
"Dypsis ambilaensis"	"nonLC"	"nonLC"	"nonLC___nonLC"
"Dypsis ambositrae"	"nonLC"	"nonLC"	"nonLC___nonLC"
"Dypsis andapae"	"nonLC"	"nonLC"	"nonLC___nonLC"
"Dypsis andilamenensis"	"nonLC"	"nonLC"	"nonLC___nonLC"
"Dypsis andrianatonga"	"nonLC"	"nonLC"	"nonLC___nonLC"
"Dypsis angusta"	"nonLC"	"nonLC"	"nonLC___nonLC"
"Dypsis angustifolia"	"nonLC"	"nonLC"	"nonLC___nonLC"
"Dypsis anjae"	"nonLC"	"nonLC"	"nonLC___nonLC"
"Dypsis ankaizinensis"	"NA"	"NA"	"NA___NA"
"Dypsis ankirindro"	"nonLC"	"nonLC"	"nonLC___nonLC"
"Dypsis antanambensis"	"nonLC"	"nonLC"	"nonLC___nonLC"
"Dypsis aquatilis"	"nonLC"	"nonLC"	"nonLC___nonLC"
"Dypsis arenarum"	"nonLC"	"nonLC"	"nonLC___nonLC"
"Dypsis baronii"	"LC"	"LC"	"LC___LC"
"Dypsis basilonga"	"nonLC"	"nonLC"	"nonLC___nonLC"
"Dypsis beentjei"	"nonLC"	"nonLC"	"nonLC___nonLC"
"Dypsis bejofo"	"nonLC"	"nonLC"	"nonLC___nonLC"
"Dypsis bernieriana"	"nonLC"	"nonLC"	"nonLC___nonLC"
"Dypsis betamponensis"	"nonLC"	"nonLC"	"nonLC___nonLC"
"Dypsis betsimisarakae"	"nonLC"	"nonLC"	"nonLC___nonLC"
"Dypsis boiviniana"	"nonLC"	"nonLC"	"nonLC___nonLC"
"Dypsis bonsai"	"nonLC"	"nonLC"	"nonLC___nonLC"
"Dypsis bosseri"	"nonLC"	"nonLC"	"nonLC___nonLC"
"Dypsis brevicaulis"	"nonLC"	"nonLC"	"nonLC___nonLC"
"Dypsis brittiana"	"nonLC"	"nonLC"	"nonLC___nonLC"
"Dypsis cabadae"	"NA"	"NA"	"NA___NA"
"Dypsis canaliculata"	"nonLC"	"nonLC"	"nonLC___nonLC"
"Dypsis carlsmithii"	"nonLC"	"nonLC"	"nonLC___nonLC"
"Dypsis catatiana"	"LC"	"LC"	"LC___LC"
"Dypsis caudata"	"nonLC"	"nonLC"	"nonLC___nonLC"
"Dypsis ceracea"	"nonLC"	"nonLC"	"nonLC___nonLC"
"Dypsis commersoniana"	"nonLC"	"nonLC"	"nonLC___nonLC"
"Dypsis concinna"	"nonLC"	"nonLC"	"nonLC___nonLC"
"Dypsis confusa"	"nonLC"	"nonLC"	"nonLC___nonLC"
"Dypsis cookei"	"nonLC"	"nonLC"	"nonLC___nonLC"
"Dypsis coriacea"	"nonLC"	"nonLC"	"nonLC___nonLC"
"Dypsis corniculata"	"nonLC"	"nonLC"	"nonLC___nonLC"
"Dypsis coursii"	"LC"	"LC"	"LC___LC"
"Dypsis crinita"	"nonLC"	"nonLC"	"nonLC___nonLC"
"Dypsis culminis"	"nonLC"	"nonLC"	"nonLC___nonLC"
"Dypsis curtisii"	"nonLC"	"nonLC"	"nonLC___nonLC"
"Dypsis decaryi"	"nonLC"	"nonLC"	"nonLC___nonLC"
"Dypsis decipiens"	"nonLC"	"nonLC"	"nonLC___nonLC"
"Dypsis delicatula"	"nonLC"	"nonLC"	"nonLC___nonLC"
"Dypsis digitata"	"nonLC"	"nonLC"	"nonLC___nonLC"
"Dypsis dracaenoides"	"nonLC"	"nonLC"	"nonLC___nonLC"
"Dypsis dransfieldii"	"nonLC"	"nonLC"	"nonLC___nonLC"
"Dypsis elegans"	"nonLC"	"nonLC"	"nonLC___nonLC"
"Dypsis eriostachys"	"nonLC"	"nonLC"	"nonLC___nonLC"
"Dypsis faneva"	"nonLC"	"nonLC"	"nonLC___nonLC"
"Dypsis fanjana"	"nonLC"	"nonLC"	"nonLC___nonLC"
"Dypsis fasciculata"	"nonLC"	"nonLC"	"nonLC___nonLC"
"Dypsis fibrosa"	"LC"	"LC"	"LC___LC"
"Dypsis forficifolia"	"LC"	"LC"	"LC___LC"
"Dypsis furcata"	"nonLC"	"nonLC"	"nonLC___nonLC"
"Dypsis gautieri"	"nonLC"	"nonLC"	"nonLC___nonLC"
"Dypsis glabrescens"	"nonLC"	"nonLC"	"nonLC___nonLC"
"Dypsis gronophyllum"	"nonLC"	"nonLC"	"nonLC___nonLC"
"Dypsis henrici"	"nonLC"	"nonLC"	"nonLC___nonLC"
"Dypsis heteromorpha"	"nonLC"	"nonLC"	"nonLC___nonLC"
"Dypsis heterophylla"	"nonLC"	"nonLC"	"nonLC___nonLC"
"Dypsis hiarakae"	"nonLC"	"nonLC"	"nonLC___nonLC"
"Dypsis hildebrandtii"	"nonLC"	"nonLC"	"nonLC___nonLC"
"Dypsis hovomantsina"	"nonLC"	"nonLC"	"nonLC___nonLC"
"Dypsis humbertii"	"nonLC"	"nonLC"	"nonLC___nonLC"
"Dypsis humblotiana"	"NA"	"NA"	"NA___NA"
"Dypsis humilis"	"nonLC"	"nonLC"	"nonLC___nonLC"
"Dypsis ifanadianae"	"nonLC"	"nonLC"	"nonLC___nonLC"
"Dypsis integra"	"nonLC"	"nonLC"	"nonLC___nonLC"
"Dypsis intermedia"	"nonLC"	"nonLC"	"nonLC___nonLC"
"Dypsis interrupta"	"nonLC"	"nonLC"	"nonLC___nonLC"
"Dypsis jeremiei"	"nonLC"	"nonLC"	"nonLC___nonLC"
"Dypsis jumelleana"	"nonLC"	"nonLC"	"nonLC___nonLC"
"Dypsis laevis"	"nonLC"	"nonLC"	"nonLC___nonLC"
"Dypsis lanceolata"	"nonLC"	"nonLC"	"nonLC___nonLC"
"Dypsis lantzeana"	"nonLC"	"nonLC"	"nonLC___nonLC"
"Dypsis lanuginosa"	"nonLC"	"nonLC"	"nonLC___nonLC"
"Dypsis lastelliana"	"LC"	"LC"	"LC___LC"
"Dypsis leptocheilos"	"nonLC"	"nonLC"	"nonLC___nonLC"
"Dypsis leucomalla"	"NA"	"NA"	"NA___NA"
"Dypsis lilacina"	"nonLC"	"nonLC"	"nonLC___nonLC"
"Dypsis linearis"	"nonLC"	"nonLC"	"nonLC___nonLC"
"Dypsis lokohoensis"	"nonLC"	"nonLC"	"nonLC___nonLC"
"Dypsis louvelii"	"nonLC"	"nonLC"	"nonLC___nonLC"
"Dypsis lutea"	"nonLC"	"nonLC"	"nonLC___nonLC"
"Dypsis lutescens"	"nonLC"	"nonLC"	"nonLC___nonLC"
"Dypsis madagascariensis"	"LC"	"LC"	"LC___LC"
"Dypsis mahia"	"nonLC"	"nonLC"	"nonLC___nonLC"
"Dypsis makirae"	"nonLC"	"nonLC"	"nonLC___nonLC"
"Dypsis malcomberi"	"nonLC"	"nonLC"	"nonLC___nonLC"
"Dypsis mananjarensis"	"nonLC"	"nonLC"	"nonLC___nonLC"
"Dypsis mangorensis"	"nonLC"	"nonLC"	"nonLC___nonLC"
"Dypsis marojejyi"	"nonLC"	"nonLC"	"nonLC___nonLC"
"Dypsis mcdonaldiana"	"nonLC"	"nonLC"	"nonLC___nonLC"
"Dypsis metallica"	"nonLC"	"nonLC"	"nonLC___nonLC"
"Dypsis minuta"	"nonLC"	"nonLC"	"nonLC___nonLC"
"Dypsis mirabilis"	"nonLC"	"nonLC"	"nonLC___nonLC"
"Dypsis mocquerysiana"	"nonLC"	"nonLC"	"nonLC___nonLC"
"Dypsis montana"	"nonLC"	"nonLC"	"nonLC___nonLC"
"Dypsis moorei"	"nonLC"	"nonLC"	"nonLC___nonLC"
"Dypsis nauseosa"	"nonLC"	"nonLC"	"nonLC___nonLC"
"Dypsis nodifera"	"LC"	"LC"	"LC___LC"
"Dypsis nossibensis"	"nonLC"	"nonLC"	"nonLC___nonLC"
"Dypsis occidentalis"	"nonLC"	"nonLC"	"nonLC___nonLC"
"Dypsis onilahensis"	"nonLC"	"nonLC"	"nonLC___nonLC"
"Dypsis oreophila"	"nonLC"	"nonLC"	"nonLC___nonLC"
"Dypsis oropedionis"	"nonLC"	"nonLC"	"nonLC___nonLC"
"Dypsis ovobontsira"	"nonLC"	"nonLC"	"nonLC___nonLC"
"Dypsis pachyramea"	"LC"	"LC"	"LC___LC"
"Dypsis paludosa"	"nonLC"	"nonLC"	"nonLC___nonLC"
"Dypsis pembana"	"nonLC"	"nonLC"	"nonLC___nonLC"
"Dypsis perrieri"	"nonLC"	"nonLC"	"nonLC___nonLC"
"Dypsis pervillei"	"nonLC"	"nonLC"	"nonLC___nonLC"
"Dypsis pilulifera"	"nonLC"	"nonLC"	"nonLC___nonLC"
"Dypsis pinnatifrons"	"LC"	"LC"	"LC___LC"
"Dypsis plumosa"	"NA"	"NA"	"NA___NA"
"Dypsis poivreana"	"nonLC"	"nonLC"	"nonLC___nonLC"
"Dypsis prestoniana"	"nonLC"	"nonLC"	"nonLC___nonLC"
"Dypsis procera"	"nonLC"	"nonLC"	"nonLC___nonLC"
"Dypsis procumbens"	"nonLC"	"nonLC"	"nonLC___nonLC"
"Dypsis psammophila"	"nonLC"	"nonLC"	"nonLC___nonLC"
"Dypsis pulchella"	"nonLC"	"nonLC"	"nonLC___nonLC"
"Dypsis pumila"	"nonLC"	"nonLC"	"nonLC___nonLC"
"Dypsis pusilla"	"nonLC"	"nonLC"	"nonLC___nonLC"
"Dypsis pustulata"	"nonLC"	"nonLC"	"nonLC___nonLC"
"Dypsis rakotonasoloi"	"nonLC"	"nonLC"	"nonLC___nonLC"
"Dypsis ramentacea"	"nonLC"	"nonLC"	"nonLC___nonLC"
"Dypsis reflexa"	"nonLC"	"nonLC"	"nonLC___nonLC"
"Dypsis remotiflora"	"nonLC"	"nonLC"	"nonLC___nonLC"
"Dypsis rivularis"	"nonLC"	"nonLC"	"nonLC___nonLC"
"Dypsis robusta"	"nonLC"	"nonLC"	"nonLC___nonLC"
"Dypsis rosea"	"NA"	"NA"	"NA___NA"
"Dypsis sahanofensis"	"nonLC"	"nonLC"	"nonLC___nonLC"
"Dypsis saintelucei"	"nonLC"	"nonLC"	"nonLC___nonLC"
"Dypsis sancta"	"nonLC"	"nonLC"	"nonLC___nonLC"
"Dypsis sanctaemariae"	"nonLC"	"nonLC"	"nonLC___nonLC"
"Dypsis scandens"	"nonLC"	"nonLC"	"nonLC___nonLC"
"Dypsis schatzii"	"nonLC"	"nonLC"	"nonLC___nonLC"
"Dypsis scottiana"	"nonLC"	"nonLC"	"nonLC___nonLC"
"Dypsis serpentina"	"nonLC"	"nonLC"	"nonLC___nonLC"
"Dypsis simianensis"	"nonLC"	"nonLC"	"nonLC___nonLC"
"Dypsis singularis"	"nonLC"	"nonLC"	"nonLC___nonLC"
"Dypsis soanieranae"	"NA"	"NA"	"NA___NA"
"Dypsis spicata"	"LC"	"LC"	"LC___LC"
"Dypsis subacaulis"	"nonLC"	"nonLC"	"nonLC___nonLC"
"Dypsis tanalensis"	"nonLC"	"nonLC"	"nonLC___nonLC"
"Dypsis tenuissima"	"nonLC"	"nonLC"	"nonLC___nonLC"
"Dypsis thermarum"	"nonLC"	"nonLC"	"nonLC___nonLC"
"Dypsis thiryana"	"nonLC"	"nonLC"	"nonLC___nonLC"
"Dypsis thouarsiana"	"NA"	"NA"	"NA___NA"
"Dypsis tokoravina"	"nonLC"	"nonLC"	"nonLC___nonLC"
"Dypsis trapezoidea"	"nonLC"	"nonLC"	"nonLC___nonLC"
"Dypsis tsaratananensis"	"nonLC"	"nonLC"	"nonLC___nonLC"
"Dypsis tsaravoasira"	"nonLC"	"nonLC"	"nonLC___nonLC"
"Dypsis turkii"	"nonLC"	"nonLC"	"nonLC___nonLC"
"Dypsis utilis"	"nonLC"	"nonLC"	"nonLC___nonLC"
"Dypsis viridis"	"nonLC"	"nonLC"	"nonLC___nonLC"
"Dypsis vonitrandambo"	"nonLC"	"nonLC"	"nonLC___nonLC"
"Elaeis guineensis"	"LC"	"LC"	"LC___LC"
"Elaeis oleifera"	"LC"	"LC"	"LC___LC"
"Eleiodoxa conferta"	"LC"	"LC"	"LC___LC"
"Eremospatha barendii"	"nonLC"	"nonLC"	"nonLC___nonLC"
"Eremospatha cabrae"	"LC"	"LC"	"LC___LC"
"Eremospatha cuspidata"	"LC"	"LC"	"LC___LC"
"Eremospatha dransfieldii"	"nonLC"	"nonLC"	"nonLC___nonLC"
"Eremospatha haullevilleana"	"LC"	"LC"	"LC___LC"
"Eremospatha hookeri"	"LC"	"LC"	"LC___LC"
"Eremospatha laurentii"	"LC"	"LC"	"LC___LC"
"Eremospatha macrocarpa"	"LC"	"LC"	"LC___LC"
"Eremospatha quinquecostulata"	"LC"	"LC"	"LC___LC"
"Eremospatha tessmanniana"	"LC"	"LC"	"LC___LC"
"Eremospatha wendlandiana"	"LC"	"LC"	"LC___LC"
"Eugeissona ambigua"	"NA"	"NA"	"NA___NA"
"Eugeissona brachystachys"	"NA"	"NA"	"NA___NA"
"Eugeissona insignis"	"NA"	"NA"	"NA___NA"
"Eugeissona minor"	"nonLC"	"nonLC"	"nonLC___nonLC"
"Eugeissona tristis"	"nonLC"	"nonLC"	"nonLC___nonLC"
"Eugeissona utilis"	"NA"	"NA"	"NA___NA"
"Euterpe broadwayi"	"nonLC"	"nonLC"	"nonLC___nonLC"
"Euterpe catinga"	"LC"	"LC"	"LC___LC"
"Euterpe edulis"	"LC"	"LC"	"LC___LC"
"Euterpe longibracteata"	"LC"	"LC"	"LC___LC"
"Euterpe luminosa"	"nonLC"	"nonLC"	"nonLC___nonLC"
"Euterpe oleracea"	"NA"	"NA"	"NA___NA"
"Euterpe precatoria"	"LC"	"LC"	"LC___LC"
"Gaussia attenuata"	"nonLC"	"nonLC"	"nonLC___nonLC"
"Gaussia gomez-pompae"	"nonLC"	"nonLC"	"nonLC___nonLC"
"Gaussia maya"	"LC"	"nonLC"	"LC___nonLC"
"Gaussia princeps"	"NA"	"NA"	"NA___NA"
"Gaussia spirituana"	"NA"	"NA"	"NA___NA"
"Geonoma aspidiifolia"	"LC"	"LC"	"LC___LC"
"Geonoma baculifera"	"LC"	"LC"	"LC___LC"
"Geonoma bernalii"	"nonLC"	"nonLC"	"nonLC___nonLC"
"Geonoma braunii"	"nonLC"	"nonLC"	"nonLC___nonLC"
"Geonoma brenesii"	"nonLC"	"nonLC"	"nonLC___nonLC"
"Geonoma brongniartii"	"LC"	"LC"	"LC___LC"
"Geonoma calyptrogynoidea"	"LC"	"LC"	"LC___LC"
"Geonoma camana"	"LC"	"LC"	"LC___LC"
"Geonoma chlamydostachys"	"nonLC"	"nonLC"	"nonLC___nonLC"
"Geonoma chococola"	"LC"	"nonLC"	"LC___nonLC"
"Geonoma concinna"	"nonLC"	"nonLC"	"nonLC___nonLC"
"Geonoma concinnoidea"	"LC"	"nonLC"	"LC___nonLC"
"Geonoma congesta"	"LC"	"LC"	"LC___LC"
"Geonoma cuneata"	"LC"	"LC"	"LC___LC"
"Geonoma deneversii"	"nonLC"	"nonLC"	"nonLC___nonLC"
"Geonoma deversa"	"LC"	"LC"	"LC___LC"
"Geonoma dindoensis"	"nonLC"	"nonLC"	"nonLC___nonLC"
"Geonoma divisa"	"LC"	"nonLC"	"LC___nonLC"
"Geonoma elegans"	"LC"	"LC"	"LC___LC"
"Geonoma epetiolata"	"LC"	"nonLC"	"LC___nonLC"
"Geonoma euspatha"	"LC"	"LC"	"LC___LC"
"Geonoma ferruginea"	"LC"	"LC"	"LC___LC"
"Geonoma fosteri"	"LC"	"nonLC"	"LC___nonLC"
"Geonoma frontinensis"	"LC"	"nonLC"	"LC___nonLC"
"Geonoma galeanoae"	"nonLC"	"nonLC"	"nonLC___nonLC"
"Geonoma gentryi"	"nonLC"	"nonLC"	"nonLC___nonLC"
"Geonoma hollinensis"	"nonLC"	"nonLC"	"nonLC___nonLC"
"Geonoma hugonis"	"LC"	"nonLC"	"LC___nonLC"
"Geonoma interrupta"	"LC"	"LC"	"LC___LC"
"Geonoma lanata"	"LC"	"nonLC"	"LC___nonLC"
"Geonoma laxiflora"	"LC"	"LC"	"LC___LC"
"Geonoma lehmannii"	"LC"	"nonLC"	"LC___nonLC"
"Geonoma leptospadix"	"LC"	"LC"	"LC___LC"
"Geonoma longepedunculata"	"LC"	"nonLC"	"LC___nonLC"
"Geonoma longivaginata"	"nonLC"	"nonLC"	"nonLC___nonLC"
"Geonoma macrostachys"	"LC"	"LC"	"LC___LC"
"Geonoma maxima"	"LC"	"LC"	"LC___LC"
"Geonoma monospatha"	"LC"	"nonLC"	"LC___nonLC"
"Geonoma mooreana"	"nonLC"	"nonLC"	"nonLC___nonLC"
"Geonoma multisecta"	"LC"	"nonLC"	"LC___nonLC"
"Geonoma occidentalis"	"LC"	"nonLC"	"LC___nonLC"
"Geonoma oldemanii"	"nonLC"	"nonLC"	"nonLC___nonLC"
"Geonoma oligoclona"	"LC"	"LC"	"LC___LC"
"Geonoma operculata"	"NA"	"NA"	"NA___NA"
"Geonoma orbignyana"	"LC"	"LC"	"LC___LC"
"Geonoma paradoxa"	"LC"	"nonLC"	"LC___nonLC"
"Geonoma pauciflora"	"LC"	"LC"	"LC___LC"
"Geonoma peruviana"	"nonLC"	"nonLC"	"nonLC___nonLC"
"Geonoma pinnatifrons"	"nonLC"	"nonLC"	"nonLC___nonLC"
"Geonoma poeppigiana"	"LC"	"LC"	"LC___LC"
"Geonoma pohliana"	"LC"	"LC"	"LC___LC"
"Geonoma poiteauana"	"LC"	"LC"	"LC___LC"
"Geonoma sanmartinensis"	"nonLC"	"nonLC"	"nonLC___nonLC"
"Geonoma santanderensis"	"nonLC"	"nonLC"	"nonLC___nonLC"
"Geonoma schizocarpa"	"nonLC"	"nonLC"	"nonLC___nonLC"
"Geonoma schottiana"	"LC"	"LC"	"LC___LC"
"Geonoma scoparia"	"nonLC"	"nonLC"	"nonLC___nonLC"
"Geonoma simplicifrons"	"nonLC"	"nonLC"	"nonLC___nonLC"
"Geonoma spinescens"	"nonLC"	"nonLC"	"nonLC___nonLC"
"Geonoma stricta"	"LC"	"LC"	"LC___LC"
"Geonoma talamancana"	"LC"	"nonLC"	"LC___nonLC"
"Geonoma tenuissima"	"nonLC"	"nonLC"	"nonLC___nonLC"
"Geonoma triandra"	"LC"	"nonLC"	"LC___nonLC"
"Geonoma triglochin"	"LC"	"LC"	"LC___LC"
"Geonoma trigona"	"LC"	"nonLC"	"LC___nonLC"
"Geonoma umbraculiformis"	"LC"	"nonLC"	"LC___nonLC"
"Geonoma undata"	"nonLC"	"nonLC"	"nonLC___nonLC"
"Geonoma venosa"	"nonLC"	"nonLC"	"nonLC___nonLC"
"Guihaia argyrata"	"LC"	"nonLC"	"LC___nonLC"
"Guihaia grossifibrosa"	"LC"	"nonLC"	"LC___nonLC"
"Guihaia lancifolia"	"NA"	"NA"	"NA___NA"
"Hedyscepe canterburyana"	"NA"	"NA"	"NA___NA"
"Hemithrinax compacta"	"NA"	"NA"	"NA___NA"
"Hemithrinax ekmaniana"	"nonLC"	"nonLC"	"nonLC___nonLC"
"Hemithrinax rivularis"	"NA"	"NA"	"NA___NA"
"Heterospathe annectens"	"nonLC"	"nonLC"	"nonLC___nonLC"
"Heterospathe arfakiana"	"nonLC"	"nonLC"	"nonLC___nonLC"
"Heterospathe barfodii"	"NA"	"NA"	"NA___NA"
"Heterospathe brevicaulis"	"nonLC"	"nonLC"	"nonLC___nonLC"
"Heterospathe cagayanensis"	"nonLC"	"nonLC"	"nonLC___nonLC"
"Heterospathe califrons"	"nonLC"	"nonLC"	"nonLC___nonLC"
"Heterospathe clemensiae"	"nonLC"	"nonLC"	"nonLC___nonLC"
"Heterospathe compsoclada"	"nonLC"	"nonLC"	"nonLC___nonLC"
"Heterospathe delicatula"	"nonLC"	"nonLC"	"nonLC___nonLC"
"Heterospathe dransfieldii"	"nonLC"	"nonLC"	"nonLC___nonLC"
"Heterospathe elata"	"LC"	"LC"	"LC___LC"
"Heterospathe elegans"	"LC"	"LC"	"LC___LC"
"Heterospathe elmeri"	"nonLC"	"nonLC"	"nonLC___nonLC"
"Heterospathe glabra"	"nonLC"	"nonLC"	"nonLC___nonLC"
"Heterospathe glauca"	"NA"	"NA"	"NA___NA"
"Heterospathe intermedia"	"nonLC"	"nonLC"	"nonLC___nonLC"
"Heterospathe kajewskii"	"NA"	"NA"	"NA___NA"
"Heterospathe ledermanniana"	"NA"	"NA"	"NA___NA"
"Heterospathe lepidota"	"nonLC"	"nonLC"	"nonLC___nonLC"
"Heterospathe longipes"	"nonLC"	"nonLC"	"nonLC___nonLC"
"Heterospathe macgregorii"	"nonLC"	"nonLC"	"nonLC___nonLC"
"Heterospathe minor"	"nonLC"	"nonLC"	"nonLC___nonLC"
"Heterospathe muelleriana"	"LC"	"nonLC"	"LC___nonLC"
"Heterospathe negrosensis"	"nonLC"	"nonLC"	"nonLC___nonLC"
"Heterospathe obriensis"	"nonLC"	"nonLC"	"nonLC___nonLC"
"Heterospathe parviflora"	"nonLC"	"nonLC"	"nonLC___nonLC"
"Heterospathe philippinensis"	"nonLC"	"nonLC"	"nonLC___nonLC"
"Heterospathe phillipsii"	"nonLC"	"nonLC"	"nonLC___nonLC"
"Heterospathe pilosa"	"NA"	"NA"	"NA___NA"
"Heterospathe porcata"	"nonLC"	"nonLC"	"nonLC___nonLC"
"Heterospathe pulchra"	"nonLC"	"nonLC"	"nonLC___nonLC"
"Heterospathe pullenii"	"nonLC"	"nonLC"	"nonLC___nonLC"
"Heterospathe ramulosa"	"NA"	"NA"	"NA___NA"
"Heterospathe salomonensis"	"NA"	"NA"	"NA___NA"
"Heterospathe scitula"	"nonLC"	"nonLC"	"nonLC___nonLC"
"Heterospathe sensisi"	"NA"	"NA"	"NA___NA"
"Heterospathe sibuyanensis"	"nonLC"	"nonLC"	"nonLC___nonLC"
"Heterospathe sphaerocarpa"	"nonLC"	"nonLC"	"nonLC___nonLC"
"Heterospathe trispatha"	"nonLC"	"nonLC"	"nonLC___nonLC"
"Heterospathe uniformis"	"NA"	"NA"	"NA___NA"
"Heterospathe woodfordiana"	"nonLC"	"nonLC"	"nonLC___nonLC"
"Howea belmoreana"	"NA"	"NA"	"NA___NA"
"Howea forsteriana"	"NA"	"NA"	"NA___NA"
"Hydriastele affinis"	"NA"	"NA"	"NA___NA"
"Hydriastele aprica"	"nonLC"	"nonLC"	"nonLC___nonLC"
"Hydriastele beccariana"	"nonLC"	"nonLC"	"nonLC___nonLC"
"Hydriastele beguinii"	"nonLC"	"nonLC"	"nonLC___nonLC"
"Hydriastele biakensis"	"nonLC"	"nonLC"	"nonLC___nonLC"
"Hydriastele boumae"	"LC"	"LC"	"LC___LC"
"Hydriastele brassii"	"nonLC"	"nonLC"	"nonLC___nonLC"
"Hydriastele cariosa"	"nonLC"	"nonLC"	"nonLC___nonLC"
"Hydriastele carrii"	"NA"	"NA"	"NA___NA"
"Hydriastele chaunostachys"	"LC"	"nonLC"	"LC___nonLC"
"Hydriastele costata"	"LC"	"LC"	"LC___LC"
"Hydriastele cyclopensis"	"NA"	"NA"	"NA___NA"
"Hydriastele cylindrocarpa"	"NA"	"NA"	"NA___NA"
"Hydriastele dransfieldii"	"nonLC"	"nonLC"	"nonLC___nonLC"
"Hydriastele flabellata"	"LC"	"nonLC"	"LC___nonLC"
"Hydriastele geelvinkiana"	"NA"	"NA"	"NA___NA"
"Hydriastele gibbsiana"	"nonLC"	"nonLC"	"nonLC___nonLC"
"Hydriastele gracilis"	"nonLC"	"nonLC"	"nonLC___nonLC"
"Hydriastele hombronii"	"nonLC"	"nonLC"	"nonLC___nonLC"
"Hydriastele kasesa"	"nonLC"	"nonLC"	"nonLC___nonLC"
"Hydriastele kjellbergii"	"NA"	"NA"	"NA___NA"
"Hydriastele ledermanniana"	"LC"	"nonLC"	"LC___nonLC"
"Hydriastele lepidota"	"NA"	"NA"	"NA___NA"
"Hydriastele longispatha"	"LC"	"nonLC"	"LC___nonLC"
"Hydriastele lurida"	"LC"	"nonLC"	"LC___nonLC"
"Hydriastele macrospadix"	"NA"	"NA"	"NA___NA"
"Hydriastele manusii"	"nonLC"	"nonLC"	"nonLC___nonLC"
"Hydriastele mayrii"	"NA"	"NA"	"NA___NA"
"Hydriastele micrantha"	"nonLC"	"nonLC"	"nonLC___nonLC"
"Hydriastele microcarpa"	"nonLC"	"nonLC"	"nonLC___nonLC"
"Hydriastele microspadix"	"NA"	"NA"	"NA___NA"
"Hydriastele moluccana"	"nonLC"	"nonLC"	"nonLC___nonLC"
"Hydriastele montana"	"nonLC"	"nonLC"	"nonLC___nonLC"
"Hydriastele nannostachys"	"nonLC"	"nonLC"	"nonLC___nonLC"
"Hydriastele oxypetala"	"NA"	"NA"	"NA___NA"
"Hydriastele palauensis"	"NA"	"NA"	"NA___NA"
"Hydriastele pinangoides"	"LC"	"LC"	"LC___LC"
"Hydriastele pleurocarpa"	"NA"	"NA"	"NA___NA"
"Hydriastele procera"	"nonLC"	"nonLC"	"nonLC___nonLC"
"Hydriastele ramsayi"	"LC"	"nonLC"	"LC___nonLC"
"Hydriastele rheophytica"	"NA"	"NA"	"NA___NA"
"Hydriastele rhopalocarpa"	"nonLC"	"nonLC"	"nonLC___nonLC"
"Hydriastele rostrata"	"NA"	"NA"	"NA___NA"
"Hydriastele sarasinorum"	"NA"	"NA"	"NA___NA"
"Hydriastele selebica"	"NA"	"NA"	"NA___NA"
"Hydriastele valida"	"nonLC"	"nonLC"	"nonLC___nonLC"
"Hydriastele variabilis"	"nonLC"	"nonLC"	"nonLC___nonLC"
"Hydriastele vitiensis"	"nonLC"	"nonLC"	"nonLC___nonLC"
"Hydriastele wendlandiana"	"LC"	"LC"	"LC___LC"
"Hyophorbe indica"	"NA"	"NA"	"NA___NA"
"Hyophorbe lagenicaulis"	"nonLC"	"nonLC"	"nonLC___nonLC"
"Hyophorbe vaughanii"	"NA"	"NA"	"NA___NA"
"Hyophorbe verschaffeltii"	"NA"	"NA"	"NA___NA"
"Hyospathe elegans"	"LC"	"LC"	"LC___LC"
"Hyospathe frontinensis"	"nonLC"	"nonLC"	"nonLC___nonLC"
"Hyospathe macrorhachis"	"nonLC"	"nonLC"	"nonLC___nonLC"
"Hyospathe peruviana"	"nonLC"	"nonLC"	"nonLC___nonLC"
"Hyospathe pittieri"	"NA"	"NA"	"NA___NA"
"Hyospathe wendlandiana"	"nonLC"	"nonLC"	"nonLC___nonLC"
"Hyphaene compressa"	"LC"	"LC"	"LC___LC"
"Hyphaene coriacea"	"LC"	"LC"	"LC___LC"
"Hyphaene dichotoma"	"NA"	"NA"	"NA___NA"
"Hyphaene guineensis"	"LC"	"LC"	"LC___LC"
"Hyphaene macrosperma"	"NA"	"NA"	"NA___NA"
"Hyphaene petersiana"	"LC"	"LC"	"LC___LC"
"Hyphaene reptans"	"LC"	"nonLC"	"LC___nonLC"
"Hyphaene thebaica"	"LC"	"LC"	"LC___LC"
"Iguanura ambigua"	"nonLC"	"nonLC"	"nonLC___nonLC"
"Iguanura asli"	"NA"	"NA"	"NA___NA"
"Iguanura belumensis"	"NA"	"NA"	"NA___NA"
"Iguanura bicornis"	"LC"	"nonLC"	"LC___nonLC"
"Iguanura borneensis"	"nonLC"	"nonLC"	"nonLC___nonLC"
"Iguanura cemurung"	"NA"	"NA"	"NA___NA"
"Iguanura chaiana"	"NA"	"NA"	"NA___NA"
"Iguanura corniculata"	"NA"	"NA"	"NA___NA"
"Iguanura curvata"	"nonLC"	"nonLC"	"nonLC___nonLC"
"Iguanura diffusa"	"nonLC"	"nonLC"	"nonLC___nonLC"
"Iguanura divergens"	"NA"	"NA"	"NA___NA"
"Iguanura elegans"	"nonLC"	"nonLC"	"nonLC___nonLC"
"Iguanura geonomiformis"	"NA"	"NA"	"NA___NA"
"Iguanura humilis"	"NA"	"NA"	"NA___NA"
"Iguanura kelantanensis"	"NA"	"NA"	"NA___NA"
"Iguanura leucocarpa"	"NA"	"NA"	"NA___NA"
"Iguanura macrostachya"	"LC"	"nonLC"	"LC___nonLC"
"Iguanura melinauensis"	"nonLC"	"nonLC"	"nonLC___nonLC"
"Iguanura minor"	"nonLC"	"nonLC"	"nonLC___nonLC"
"Iguanura mirabilis"	"NA"	"NA"	"NA___NA"
"Iguanura myochodoides"	"nonLC"	"nonLC"	"nonLC___nonLC"
"Iguanura palmuncula"	"nonLC"	"nonLC"	"nonLC___nonLC"
"Iguanura parvula"	"NA"	"NA"	"NA___NA"
"Iguanura perdana"	"NA"	"NA"	"NA___NA"
"Iguanura piahensis"	"NA"	"NA"	"NA___NA"
"Iguanura polymorpha"	"LC"	"nonLC"	"LC___nonLC"
"Iguanura prolifera"	"nonLC"	"nonLC"	"nonLC___nonLC"
"Iguanura remotiflora"	"NA"	"NA"	"NA___NA"
"Iguanura sanderiana"	"nonLC"	"nonLC"	"nonLC___nonLC"
"Iguanura speciosa"	"NA"	"NA"	"NA___NA"
"Iguanura tenuis"	"NA"	"NA"	"NA___NA"
"Iguanura thalangensis"	"nonLC"	"nonLC"	"nonLC___nonLC"
"Iguanura wallichiana"	"LC"	"LC"	"LC___LC"
"Iriartea deltoidea"	"LC"	"LC"	"LC___LC"
"Iriartella setigera"	"LC"	"LC"	"LC___LC"
"Iriartella stenocarpa"	"LC"	"LC"	"LC___LC"
"Itaya amicorum"	"LC"	"LC"	"LC___LC"
"Jailoloa halmaherensis"	"nonLC"	"nonLC"	"nonLC___nonLC"
"Johannesteijsmannia altifrons"	"LC"	"LC"	"LC___LC"
"Johannesteijsmannia lanceolata"	"NA"	"NA"	"NA___NA"
"Johannesteijsmannia magnifica"	"NA"	"NA"	"NA___NA"
"Johannesteijsmannia perakensis"	"NA"	"NA"	"NA___NA"
"Juania australis"	"NA"	"NA"	"NA___NA"
"Jubaea chilensis"	"nonLC"	"nonLC"	"nonLC___nonLC"
"Jubaeopsis caffra"	"LC"	"nonLC"	"LC___nonLC"
"Kentiopsis magnifica"	"nonLC"	"nonLC"	"nonLC___nonLC"
"Kentiopsis oliviformis"	"nonLC"	"nonLC"	"nonLC___nonLC"
"Kentiopsis piersoniorum"	"nonLC"	"nonLC"	"nonLC___nonLC"
"Kentiopsis pyriformis"	"nonLC"	"nonLC"	"nonLC___nonLC"
"Kerriodoxa elegans"	"nonLC"	"nonLC"	"nonLC___nonLC"
"Korthalsia angustifolia"	"nonLC"	"nonLC"	"nonLC___nonLC"
"Korthalsia bejaudii"	"NA"	"NA"	"NA___NA"
"Korthalsia brassii"	"nonLC"	"nonLC"	"nonLC___nonLC"
"Korthalsia celebica"	"nonLC"	"nonLC"	"nonLC___nonLC"
"Korthalsia cheb"	"LC"	"nonLC"	"LC___nonLC"
"Korthalsia concolor"	"nonLC"	"nonLC"	"nonLC___nonLC"
"Korthalsia debilis"	"LC"	"nonLC"	"LC___nonLC"
"Korthalsia echinometra"	"LC"	"LC"	"LC___LC"
"Korthalsia ferox"	"LC"	"nonLC"	"LC___nonLC"
"Korthalsia flagellaris"	"LC"	"nonLC"	"LC___nonLC"
"Korthalsia furcata"	"NA"	"NA"	"NA___NA"
"Korthalsia furtadoana"	"LC"	"nonLC"	"LC___nonLC"
"Korthalsia hispida"	"LC"	"nonLC"	"LC___nonLC"
"Korthalsia jala"	"nonLC"	"nonLC"	"nonLC___nonLC"
"Korthalsia junghuhnii"	"nonLC"	"nonLC"	"nonLC___nonLC"
"Korthalsia laciniosa"	"LC"	"LC"	"LC___LC"
"Korthalsia lanceolata"	"NA"	"NA"	"NA___NA"
"Korthalsia merrillii"	"NA"	"NA"	"NA___NA"
"Korthalsia minor"	"LC"	"nonLC"	"LC___nonLC"
"Korthalsia paucijuga"	"NA"	"NA"	"NA___NA"
"Korthalsia rigida"	"LC"	"LC"	"LC___LC"
"Korthalsia robusta"	"LC"	"LC"	"LC___LC"
"Korthalsia rogersii"	"NA"	"NA"	"NA___NA"
"Korthalsia rostrata"	"LC"	"LC"	"LC___LC"
"Korthalsia scaphigeroides"	"NA"	"NA"	"NA___NA"
"Korthalsia scortechinii"	"NA"	"NA"	"NA___NA"
"Korthalsia tenuissima"	"NA"	"NA"	"NA___NA"
"Korthalsia zippelii"	"LC"	"LC"	"LC___LC"
"Laccospadix australasicus"	"LC"	"nonLC"	"LC___nonLC"
"Laccosperma acutiflorum"	"LC"	"LC"	"LC___LC"
"Laccosperma cristalensis"	"NA"	"NA"	"NA___NA"
"Laccosperma korupense"	"NA"	"NA"	"NA___NA"
"Laccosperma laeve"	"LC"	"LC"	"LC___LC"
"Laccosperma opacum"	"LC"	"LC"	"LC___LC"
"Laccosperma robustum"	"LC"	"LC"	"LC___LC"
"Laccosperma secundiflorum"	"LC"	"LC"	"LC___LC"
"Lanonia acaulis"	"nonLC"	"nonLC"	"nonLC___nonLC"
"Lanonia calciphila"	"LC"	"nonLC"	"LC___nonLC"
"Lanonia centralis"	"LC"	"nonLC"	"LC___nonLC"
"Lanonia dasyantha"	"LC"	"nonLC"	"LC___nonLC"
"Lanonia gracilis"	"NA"	"NA"	"NA___NA"
"Lanonia hainanensis"	"nonLC"	"nonLC"	"nonLC___nonLC"
"Lanonia hexasepala"	"nonLC"	"nonLC"	"nonLC___nonLC"
"Lanonia magalonii"	"nonLC"	"nonLC"	"nonLC___nonLC"
"Latania loddigesii"	"NA"	"NA"	"NA___NA"
"Latania lontaroides"	"NA"	"NA"	"NA___NA"
"Latania verschaffeltii"	"nonLC"	"nonLC"	"nonLC___nonLC"
"Lemurophoenix halleuxii"	"nonLC"	"nonLC"	"nonLC___nonLC"
"Leopoldinia piassaba"	"LC"	"nonLC"	"LC___nonLC"
"Leopoldinia pulchra"	"LC"	"LC"	"LC___LC"
"Lepidocaryum tenue"	"LC"	"LC"	"LC___LC"
"Lepidorrhachis mooreana"	"NA"	"NA"	"NA___NA"
"Leucothrinax morrisii"	"LC"	"LC"	"LC___LC"
"Licuala acuminata"	"nonLC"	"nonLC"	"nonLC___nonLC"
"Licuala acutifida"	"NA"	"NA"	"NA___NA"
"Licuala adscendens"	"NA"	"NA"	"NA___NA"
"Licuala ahlidurii"	"nonLC"	"nonLC"	"nonLC___nonLC"
"Licuala angustiloba"	"nonLC"	"nonLC"	"nonLC___nonLC"
"Licuala anomala"	"nonLC"	"nonLC"	"nonLC___nonLC"
"Licuala aruensis"	"NA"	"NA"	"NA___NA"
"Licuala atrovirens"	"LC"	"nonLC"	"LC___nonLC"
"Licuala atroviridis"	"nonLC"	"nonLC"	"nonLC___nonLC"
"Licuala averyanovii"	"nonLC"	"nonLC"	"nonLC___nonLC"
"Licuala bachmaensis"	"nonLC"	"nonLC"	"nonLC___nonLC"
"Licuala bacularia"	"LC"	"nonLC"	"LC___nonLC"
"Licuala bayana"	"NA"	"NA"	"NA___NA"
"Licuala beccariana"	"LC"	"nonLC"	"LC___nonLC"
"Licuala bellatula"	"LC"	"nonLC"	"LC___nonLC"
"Licuala bidentata"	"LC"	"LC"	"LC___LC"
"Licuala bidoupensis"	"nonLC"	"nonLC"	"nonLC___nonLC"
"Licuala bifida"	"nonLC"	"nonLC"	"nonLC___nonLC"
"Licuala bintulensis"	"nonLC"	"nonLC"	"nonLC___nonLC"
"Licuala bissula"	"NA"	"NA"	"NA___NA"
"Licuala borneensis"	"nonLC"	"nonLC"	"nonLC___nonLC"
"Licuala bracteata"	"nonLC"	"nonLC"	"nonLC___nonLC"
"Licuala brevicalyx"	"nonLC"	"nonLC"	"nonLC___nonLC"
"Licuala bruneiana"	"nonLC"	"nonLC"	"nonLC___nonLC"
"Licuala burretii"	"nonLC"	"nonLC"	"nonLC___nonLC"
"Licuala cabalionii"	"NA"	"NA"	"NA___NA"
"Licuala cameronensis"	"NA"	"NA"	"NA___NA"
"Licuala campestris"	"LC"	"LC"	"LC___LC"
"Licuala cattienensis"	"nonLC"	"nonLC"	"nonLC___nonLC"
"Licuala celebica"	"nonLC"	"nonLC"	"nonLC___nonLC"
"Licuala chaiana"	"nonLC"	"nonLC"	"nonLC___nonLC"
"Licuala collina"	"nonLC"	"nonLC"	"nonLC___nonLC"
"Licuala concinna"	"LC"	"nonLC"	"LC___nonLC"
"Licuala cordata"	"nonLC"	"nonLC"	"nonLC___nonLC"
"Licuala corneri"	"NA"	"NA"	"NA___NA"
"Licuala crassiflora"	"nonLC"	"nonLC"	"nonLC___nonLC"
"Licuala dakrongensis"	"nonLC"	"nonLC"	"nonLC___nonLC"
"Licuala debilis"	"NA"	"NA"	"NA___NA"
"Licuala densiflora"	"nonLC"	"nonLC"	"nonLC___nonLC"
"Licuala distans"	"nonLC"	"nonLC"	"nonLC___nonLC"
"Licuala egregia"	"NA"	"NA"	"NA___NA"
"Licuala elegans"	"NA"	"NA"	"NA___NA"
"Licuala ellipsoidalis"	"nonLC"	"nonLC"	"nonLC___nonLC"
"Licuala elliptica"	"nonLC"	"nonLC"	"nonLC___nonLC"
"Licuala exigua"	"NA"	"NA"	"NA___NA"
"Licuala ferruginea"	"nonLC"	"nonLC"	"nonLC___nonLC"
"Licuala ferruginoides"	"NA"	"NA"	"NA___NA"
"Licuala flammula"	"nonLC"	"nonLC"	"nonLC___nonLC"
"Licuala flavida"	"nonLC"	"nonLC"	"nonLC___nonLC"
"Licuala flexuosa"	"nonLC"	"nonLC"	"nonLC___nonLC"
"Licuala fordiana"	"LC"	"LC"	"LC___LC"
"Licuala fractiflexa"	"NA"	"NA"	"NA___NA"
"Licuala gjellerupii"	"NA"	"NA"	"NA___NA"
"Licuala glaberrima"	"nonLC"	"nonLC"	"nonLC___nonLC"
"Licuala glabra"	"nonLC"	"nonLC"	"nonLC___nonLC"
"Licuala graminifolia"	"NA"	"NA"	"NA___NA"
"Licuala grandiflora"	"nonLC"	"nonLC"	"nonLC___nonLC"
"Licuala grandis"	"LC"	"nonLC"	"LC___nonLC"
"Licuala hallieriana"	"nonLC"	"nonLC"	"nonLC___nonLC"
"Licuala insignis"	"LC"	"nonLC"	"LC___nonLC"
"Licuala intermedia"	"LC"	"LC"	"LC___LC"
"Licuala kamarudinii"	"NA"	"NA"	"NA___NA"
"Licuala kemamanensis"	"NA"	"NA"	"NA___NA"
"Licuala khoonmengii"	"NA"	"NA"	"NA___NA"
"Licuala kiahii"	"NA"	"NA"	"NA___NA"
"Licuala kingiana"	"NA"	"NA"	"NA___NA"
"Licuala klossii"	"nonLC"	"nonLC"	"nonLC___nonLC"
"Licuala kuchingensis"	"nonLC"	"nonLC"	"nonLC___nonLC"
"Licuala kunstleri"	"nonLC"	"nonLC"	"nonLC___nonLC"
"Licuala lambii"	"NA"	"NA"	"NA___NA"
"Licuala lanata"	"nonLC"	"nonLC"	"nonLC___nonLC"
"Licuala lanuginosa"	"NA"	"NA"	"NA___NA"
"Licuala lauterbachii"	"LC"	"LC"	"LC___LC"
"Licuala leopoldii"	"NA"	"NA"	"NA___NA"
"Licuala leprosa"	"NA"	"NA"	"NA___NA"
"Licuala leptocalyx"	"NA"	"NA"	"NA___NA"
"Licuala leucocarpa"	"NA"	"NA"	"NA___NA"
"Licuala linearis"	"nonLC"	"nonLC"	"nonLC___nonLC"
"Licuala longicalycata"	"NA"	"NA"	"NA___NA"
"Licuala longiflora"	"nonLC"	"nonLC"	"nonLC___nonLC"
"Licuala longipes"	"LC"	"nonLC"	"LC___nonLC"
"Licuala longispadix"	"nonLC"	"nonLC"	"nonLC___nonLC"
"Licuala macrantha"	"nonLC"	"nonLC"	"nonLC___nonLC"
"Licuala maculata"	"NA"	"NA"	"NA___NA"
"Licuala magna"	"nonLC"	"nonLC"	"nonLC___nonLC"
"Licuala malajana"	"LC"	"LC"	"LC___LC"
"Licuala manglaensis"	"nonLC"	"nonLC"	"nonLC___nonLC"
"Licuala mattanensis"	"nonLC"	"nonLC"	"nonLC___nonLC"
"Licuala meijeri"	"nonLC"	"nonLC"	"nonLC___nonLC"
"Licuala merguensis"	"LC"	"nonLC"	"LC___nonLC"
"Licuala micholitzii"	"nonLC"	"nonLC"	"nonLC___nonLC"
"Licuala micrantha"	"nonLC"	"nonLC"	"nonLC___nonLC"
"Licuala mirabilis"	"NA"	"NA"	"NA___NA"
"Licuala miriensis"	"nonLC"	"nonLC"	"nonLC___nonLC"
"Licuala modesta"	"nonLC"	"nonLC"	"nonLC___nonLC"
"Licuala montana"	"LC"	"nonLC"	"LC___nonLC"
"Licuala moszkowskiana"	"nonLC"	"nonLC"	"nonLC___nonLC"
"Licuala moyseyi"	"NA"	"NA"	"NA___NA"
"Licuala mukahensis"	"nonLC"	"nonLC"	"nonLC___nonLC"
"Licuala mustapana"	"NA"	"NA"	"NA___NA"
"Licuala nana"	"NA"	"NA"	"NA___NA"
"Licuala naumannii"	"NA"	"NA"	"NA___NA"
"Licuala naumoniensis"	"nonLC"	"nonLC"	"nonLC___nonLC"
"Licuala olivifera"	"LC"	"LC"	"LC___LC"
"Licuala oliviformis"	"NA"	"NA"	"NA___NA"
"Licuala oninensis"	"NA"	"NA"	"NA___NA"
"Licuala orbicularis"	"nonLC"	"nonLC"	"nonLC___nonLC"
"Licuala oryzoides"	"NA"	"NA"	"NA___NA"
"Licuala pachycalyx"	"NA"	"NA"	"NA___NA"
"Licuala pahangensis"	"NA"	"NA"	"NA___NA"
"Licuala palas"	"NA"	"NA"	"NA___NA"
"Licuala paludosa"	"nonLC"	"nonLC"	"nonLC___nonLC"
"Licuala parviflora"	"nonLC"	"nonLC"	"nonLC___nonLC"
"Licuala patens"	"NA"	"NA"	"NA___NA"
"Licuala paucisecta"	"nonLC"	"nonLC"	"nonLC___nonLC"
"Licuala peekelii"	"NA"	"NA"	"NA___NA"
"Licuala peltata"	"LC"	"LC"	"LC___LC"
"Licuala penduliflora"	"LC"	"nonLC"	"LC___nonLC"
"Licuala petiolulata"	"LC"	"LC"	"LC___LC"
"Licuala pilosa"	"NA"	"NA"	"NA___NA"
"Licuala pitta"	"NA"	"NA"	"NA___NA"
"Licuala platydactyla"	"nonLC"	"nonLC"	"nonLC___nonLC"
"Licuala polyschista"	"NA"	"NA"	"NA___NA"
"Licuala poonsakii"	"nonLC"	"nonLC"	"nonLC___nonLC"
"Licuala pseudovalida"	"LC"	"nonLC"	"LC___nonLC"
"Licuala pulchella"	"NA"	"NA"	"NA___NA"
"Licuala pumila"	"LC"	"nonLC"	"LC___nonLC"
"Licuala punctulata"	"nonLC"	"nonLC"	"nonLC___nonLC"
"Licuala pusilla"	"NA"	"NA"	"NA___NA"
"Licuala radula"	"NA"	"NA"	"NA___NA"
"Licuala ramsayi"	"LC"	"nonLC"	"LC___nonLC"
"Licuala reptans"	"NA"	"NA"	"NA___NA"
"Licuala rheophytica"	"nonLC"	"nonLC"	"nonLC___nonLC"
"Licuala ridleyana"	"NA"	"NA"	"NA___NA"
"Licuala robinsoniana"	"nonLC"	"nonLC"	"nonLC___nonLC"
"Licuala robusta"	"NA"	"NA"	"NA___NA"
"Licuala rubiginosa"	"nonLC"	"nonLC"	"nonLC___nonLC"
"Licuala rumphii"	"nonLC"	"nonLC"	"nonLC___nonLC"
"Licuala ruthiae"	"NA"	"NA"	"NA___NA"
"Licuala sabahana"	"nonLC"	"nonLC"	"nonLC___nonLC"
"Licuala sallehana"	"NA"	"NA"	"NA___NA"
"Licuala sarawakensis"	"nonLC"	"nonLC"	"nonLC___nonLC"
"Licuala scortechinii"	"nonLC"	"nonLC"	"nonLC___nonLC"
"Licuala simplex"	"nonLC"	"nonLC"	"nonLC___nonLC"
"Licuala spathellifera"	"nonLC"	"nonLC"	"nonLC___nonLC"
"Licuala spectabilis"	"NA"	"NA"	"NA___NA"
"Licuala spicata"	"nonLC"	"nonLC"	"nonLC___nonLC"
"Licuala spinosa"	"LC"	"LC"	"LC___LC"
"Licuala steinii"	"NA"	"NA"	"NA___NA"
"Licuala stongensis"	"NA"	"NA"	"NA___NA"
"Licuala tanycola"	"nonLC"	"nonLC"	"nonLC___nonLC"
"Licuala taynguyensis"	"NA"	"NA"	"NA___NA"
"Licuala telifera"	"LC"	"LC"	"LC___LC"
"Licuala tenuissima"	"NA"	"NA"	"NA___NA"
"Licuala terengganuensis"	"NA"	"NA"	"NA___NA"
"Licuala thoana"	"NA"	"NA"	"NA___NA"
"Licuala tiomanensis"	"NA"	"NA"	"NA___NA"
"Licuala triphylla"	"LC"	"LC"	"LC___LC"
"Licuala urciflora"	"NA"	"NA"	"NA___NA"
"Licuala whitmorei"	"NA"	"NA"	"NA___NA"
"Licuala yiiana"	"nonLC"	"nonLC"	"nonLC___nonLC"
"Linospadix albertisianus"	"LC"	"LC"	"LC___LC"
"Linospadix apetiolatus"	"nonLC"	"nonLC"	"nonLC___nonLC"
"Linospadix caninus"	"nonLC"	"nonLC"	"nonLC___nonLC"
"Linospadix microcaryus"	"nonLC"	"nonLC"	"nonLC___nonLC"
"Linospadix minor"	"LC"	"nonLC"	"LC___nonLC"
"Linospadix monostachyos"	"LC"	"LC"	"LC___LC"
"Linospadix palmerianus"	"nonLC"	"nonLC"	"nonLC___nonLC"
"Livistona alfredii"	"LC"	"nonLC"	"LC___nonLC"
"Livistona australis"	"LC"	"LC"	"LC___LC"
"Livistona benthamii"	"LC"	"LC"	"LC___LC"
"Livistona boninensis"	"NA"	"NA"	"NA___NA"
"Livistona carinensis"	"LC"	"nonLC"	"LC___nonLC"
"Livistona chinensis"	"LC"	"LC"	"LC___LC"
"Livistona concinna"	"nonLC"	"nonLC"	"nonLC___nonLC"
"Livistona decora"	"LC"	"LC"	"LC___LC"
"Livistona drudei"	"nonLC"	"nonLC"	"nonLC___nonLC"
"Livistona eastonii"	"LC"	"nonLC"	"LC___nonLC"
"Livistona endauensis"	"NA"	"NA"	"NA___NA"
"Livistona exigua"	"nonLC"	"nonLC"	"nonLC___nonLC"
"Livistona fulva"	"nonLC"	"nonLC"	"nonLC___nonLC"
"Livistona halongensis"	"NA"	"NA"	"NA___NA"
"Livistona humilis"	"LC"	"LC"	"LC___LC"
"Livistona inermis"	"LC"	"LC"	"LC___LC"
"Livistona jenkinsiana"	"LC"	"nonLC"	"LC___nonLC"
"Livistona lanuginosa"	"LC"	"nonLC"	"LC___nonLC"
"Livistona lorophylla"	"LC"	"LC"	"LC___LC"
"Livistona mariae"	"LC"	"nonLC"	"LC___nonLC"
"Livistona muelleri"	"LC"	"LC"	"LC___LC"
"Livistona nasmophila"	"nonLC"	"nonLC"	"nonLC___nonLC"
"Livistona nitida"	"LC"	"nonLC"	"LC___nonLC"
"Livistona rigida"	"LC"	"LC"	"LC___LC"
"Livistona saribus"	"LC"	"LC"	"LC___LC"
"Livistona speciosa"	"LC"	"LC"	"LC___LC"
"Livistona tahanensis"	"NA"	"NA"	"NA___NA"
"Livistona victoriae"	"LC"	"nonLC"	"LC___nonLC"
"Lodoicea maldivica"	"nonLC"	"nonLC"	"nonLC___nonLC"
"Loxococcus rupicola"	"NA"	"NA"	"NA___NA"
"Manicaria martiana"	"LC"	"nonLC"	"LC___nonLC"
"Manicaria saccifera"	"LC"	"LC"	"LC___LC"
"Manjekia maturbongsii"	"nonLC"	"nonLC"	"nonLC___nonLC"
"Marojejya darianii"	"nonLC"	"nonLC"	"nonLC___nonLC"
"Marojejya insignis"	"LC"	"LC"	"LC___LC"
"Masoala kona"	"nonLC"	"nonLC"	"nonLC___nonLC"
"Masoala madagascariensis"	"nonLC"	"nonLC"	"nonLC___nonLC"
"Mauritia carana"	"LC"	"nonLC"	"LC___nonLC"
"Mauritia flexuosa"	"LC"	"LC"	"LC___LC"
"Mauritiella aculeata"	"LC"	"LC"	"LC___LC"
"Mauritiella armata"	"LC"	"LC"	"LC___LC"
"Mauritiella macroclada"	"LC"	"nonLC"	"LC___nonLC"
"Mauritiella pumila"	"LC"	"nonLC"	"LC___nonLC"
"Maxburretia furtadoana"	"nonLC"	"nonLC"	"nonLC___nonLC"
"Maxburretia gracilis"	"nonLC"	"nonLC"	"nonLC___nonLC"
"Maxburretia rupicola"	"NA"	"NA"	"NA___NA"
"Medemia argun"	"LC"	"nonLC"	"LC___nonLC"
"Metroxylon amicarum"	"nonLC"	"nonLC"	"nonLC___nonLC"
"Metroxylon paulcoxii"	"NA"	"NA"	"NA___NA"
"Metroxylon sagu"	"LC"	"LC"	"LC___LC"
"Metroxylon salomonense"	"LC"	"nonLC"	"LC___nonLC"
"Metroxylon upoluense"	"NA"	"NA"	"NA___NA"
"Metroxylon vitiense"	"nonLC"	"nonLC"	"nonLC___nonLC"
"Metroxylon warburgii"	"LC"	"nonLC"	"LC___nonLC"
"Myrialepis paradoxa"	"LC"	"LC"	"LC___LC"
"Nannorrhops baluchestanica"	"NA"	"NA"	"NA___NA"
"Nannorrhops ritchieana"	"LC"	"nonLC"	"LC___nonLC"
"Nenga banaensis"	"LC"	"nonLC"	"LC___nonLC"
"Nenga gajah"	"nonLC"	"nonLC"	"nonLC___nonLC"
"Nenga grandiflora"	"NA"	"NA"	"NA___NA"
"Nenga macrocarpa"	"LC"	"nonLC"	"LC___nonLC"
"Nenga pumila"	"LC"	"LC"	"LC___LC"
"Neonicholsonia watsonii"	"LC"	"LC"	"LC___LC"
"Neoveitchia brunnea"	"nonLC"	"nonLC"	"nonLC___nonLC"
"Neoveitchia storckii"	"nonLC"	"nonLC"	"nonLC___nonLC"
"Nephrosperma vanhoutteanum"	"LC"	"LC"	"LC___LC"
"Normanbya normanbyi"	"nonLC"	"nonLC"	"nonLC___nonLC"
"Nypa fruticans"	"LC"	"LC"	"LC___LC"
"Oenocarpus bacaba"	"LC"	"LC"	"LC___LC"
"Oenocarpus balickii"	"NA"	"NA"	"NA___NA"
"Oenocarpus bataua"	"LC"	"LC"	"LC___LC"
"Oenocarpus circumtextus"	"LC"	"nonLC"	"LC___nonLC"
"Oenocarpus distichus"	"LC"	"LC"	"LC___LC"
"Oenocarpus makeru"	"nonLC"	"nonLC"	"nonLC___nonLC"
"Oenocarpus mapora"	"LC"	"LC"	"LC___LC"
"Oenocarpus minor"	"LC"	"LC"	"LC___LC"
"Oenocarpus simplex"	"nonLC"	"nonLC"	"nonLC___nonLC"
"Oncocalamus macrospathus"	"LC"	"LC"	"LC___LC"
"Oncocalamus mannii"	"LC"	"LC"	"LC___LC"
"Oncocalamus tuleyi"	"LC"	"LC"	"LC___LC"
"Oncocalamus wrightianus"	"nonLC"	"nonLC"	"nonLC___nonLC"
"Oncosperma fasciculatum"	"NA"	"NA"	"NA___NA"
"Oncosperma gracilipes"	"nonLC"	"nonLC"	"nonLC___nonLC"
"Oncosperma horridum"	"LC"	"LC"	"LC___LC"
"Oncosperma platyphyllum"	"nonLC"	"nonLC"	"nonLC___nonLC"
"Oncosperma tigillarium"	"LC"	"LC"	"LC___LC"
"Orania archboldiana"	"nonLC"	"nonLC"	"nonLC___nonLC"
"Orania bakeri"	"nonLC"	"nonLC"	"nonLC___nonLC"
"Orania dafonsoroensis"	"nonLC"	"nonLC"	"nonLC___nonLC"
"Orania decipiens"	"nonLC"	"nonLC"	"nonLC___nonLC"
"Orania deflexa"	"nonLC"	"nonLC"	"nonLC___nonLC"
"Orania disticha"	"LC"	"nonLC"	"LC___nonLC"
"Orania ferruginea"	"nonLC"	"nonLC"	"nonLC___nonLC"
"Orania gagavu"	"nonLC"	"nonLC"	"nonLC___nonLC"
"Orania glauca"	"nonLC"	"nonLC"	"nonLC___nonLC"
"Orania grandiflora"	"nonLC"	"nonLC"	"nonLC___nonLC"
"Orania lauterbachiana"	"LC"	"nonLC"	"LC___nonLC"
"Orania littoralis"	"nonLC"	"nonLC"	"nonLC___nonLC"
"Orania longisquama"	"LC"	"LC"	"LC___LC"
"Orania longistaminodia"	"nonLC"	"nonLC"	"nonLC___nonLC"
"Orania macropetala"	"LC"	"nonLC"	"LC___nonLC"
"Orania micrantha"	"nonLC"	"nonLC"	"nonLC___nonLC"
"Orania oreophila"	"nonLC"	"nonLC"	"nonLC___nonLC"
"Orania palindan"	"LC"	"LC"	"LC___LC"
"Orania paraguanensis"	"LC"	"nonLC"	"LC___nonLC"
"Orania parva"	"NA"	"NA"	"NA___NA"
"Orania ravaka"	"nonLC"	"nonLC"	"nonLC___nonLC"
"Orania regalis"	"LC"	"nonLC"	"LC___nonLC"
"Orania subdisticha"	"nonLC"	"nonLC"	"nonLC___nonLC"
"Orania sylvicola"	"LC"	"LC"	"LC___LC"
"Orania tabubilensis"	"nonLC"	"nonLC"	"nonLC___nonLC"
"Orania timikae"	"nonLC"	"nonLC"	"nonLC___nonLC"
"Orania trispatha"	"nonLC"	"nonLC"	"nonLC___nonLC"
"Orania zonae"	"nonLC"	"nonLC"	"nonLC___nonLC"
"Oraniopsis appendiculata"	"LC"	"nonLC"	"LC___nonLC"
"Parajubaea cocoides"	"LC"	"nonLC"	"LC___nonLC"
"Parajubaea sunkha"	"nonLC"	"nonLC"	"nonLC___nonLC"
"Parajubaea torallyi"	"nonLC"	"nonLC"	"nonLC___nonLC"
"Pelagodoxa henryana"	"NA"	"NA"	"NA___NA"
"Phoenicophorium borsigianum"	"LC"	"LC"	"LC___LC"
"Phoenix acaulis"	"NA"	"NA"	"NA___NA"
"Phoenix atlantica"	"nonLC"	"nonLC"	"nonLC___nonLC"
"Phoenix caespitosa"	"LC"	"LC"	"LC___LC"
"Phoenix canariensis"	"LC"	"LC"	"LC___LC"
"Phoenix dactylifera"	"LC"	"LC"	"LC___LC"
"Phoenix loureiroi"	"LC"	"LC"	"LC___LC"
"Phoenix paludosa"	"nonLC"	"nonLC"	"nonLC___nonLC"
"Phoenix pusilla"	"NA"	"NA"	"NA___NA"
"Phoenix reclinata"	"LC"	"LC"	"LC___LC"
"Phoenix roebelenii"	"LC"	"LC"	"LC___LC"
"Phoenix rupicola"	"NA"	"NA"	"NA___NA"
"Phoenix sylvestris"	"NA"	"NA"	"NA___NA"
"Phoenix theophrasti"	"LC"	"nonLC"	"LC___nonLC"
"Pholidocarpus ihur"	"nonLC"	"nonLC"	"nonLC___nonLC"
"Pholidocarpus kingianus"	"NA"	"NA"	"NA___NA"
"Pholidocarpus macrocarpus"	"LC"	"nonLC"	"LC___nonLC"
"Pholidocarpus majadum"	"LC"	"LC"	"LC___LC"
"Pholidocarpus mucronatus"	"NA"	"NA"	"NA___NA"
"Pholidocarpus sumatranus"	"nonLC"	"nonLC"	"nonLC___nonLC"
"Pholidostachys amazonensis"	"NA"	"NA"	"NA___NA"
"Pholidostachys dactyloides"	"LC"	"LC"	"LC___LC"
"Pholidostachys kalbreyeri"	"nonLC"	"nonLC"	"nonLC___nonLC"
"Pholidostachys occidentalis"	"LC"	"nonLC"	"LC___nonLC"
"Pholidostachys panamensis"	"LC"	"nonLC"	"LC___nonLC"
"Pholidostachys pulchra"	"NA"	"NA"	"NA___NA"
"Pholidostachys sanluisensis"	"nonLC"	"nonLC"	"nonLC___nonLC"
"Pholidostachys synanthera"	"LC"	"LC"	"LC___LC"
"Physokentia avia"	"nonLC"	"nonLC"	"nonLC___nonLC"
"Physokentia dennisii"	"NA"	"NA"	"NA___NA"
"Physokentia insolita"	"nonLC"	"nonLC"	"nonLC___nonLC"
"Physokentia petiolata"	"nonLC"	"nonLC"	"nonLC___nonLC"
"Physokentia tete"	"NA"	"NA"	"NA___NA"
"Physokentia thurstonii"	"nonLC"	"nonLC"	"nonLC___nonLC"
"Physokentia whitmorei"	"NA"	"NA"	"NA___NA"
"Phytelephas aequatorialis"	"LC"	"nonLC"	"LC___nonLC"
"Phytelephas macrocarpa"	"LC"	"LC"	"LC___LC"
"Phytelephas tenuicaulis"	"LC"	"LC"	"LC___LC"
"Phytelephas tumacana"	"nonLC"	"nonLC"	"nonLC___nonLC"
"Pigafetta elata"	"NA"	"NA"	"NA___NA"
"Pigafetta filaris"	"LC"	"nonLC"	"LC___nonLC"
"Pinanga acaulis"	"NA"	"NA"	"NA___NA"
"Pinanga acuminata"	"LC"	"nonLC"	"LC___nonLC"
"Pinanga adangensis"	"LC"	"nonLC"	"LC___nonLC"
"Pinanga albescens"	"LC"	"nonLC"	"LC___nonLC"
"Pinanga andamanensis"	"NA"	"NA"	"NA___NA"
"Pinanga angustisecta"	"nonLC"	"nonLC"	"nonLC___nonLC"
"Pinanga annamensis"	"nonLC"	"nonLC"	"nonLC___nonLC"
"Pinanga arinasae"	"LC"	"nonLC"	"LC___nonLC"
"Pinanga aristata"	"LC"	"nonLC"	"LC___nonLC"
"Pinanga arundinacea"	"NA"	"NA"	"NA___NA"
"Pinanga auriculata"	"LC"	"LC"	"LC___LC"
"Pinanga badia"	"NA"	"NA"	"NA___NA"
"Pinanga basilanensis"	"NA"	"NA"	"NA___NA"
"Pinanga batanensis"	"nonLC"	"nonLC"	"nonLC___nonLC"
"Pinanga baviensis"	"LC"	"LC"	"LC___LC"
"Pinanga bicolana"	"nonLC"	"nonLC"	"nonLC___nonLC"
"Pinanga borneensis"	"NA"	"NA"	"NA___NA"
"Pinanga brevipes"	"LC"	"nonLC"	"LC___nonLC"
"Pinanga brewsteriana"	"NA"	"NA"	"NA___NA"
"Pinanga caesia"	"nonLC"	"nonLC"	"nonLC___nonLC"
"Pinanga capitata"	"LC"	"nonLC"	"LC___nonLC"
"Pinanga cattienensis"	"nonLC"	"nonLC"	"nonLC___nonLC"
"Pinanga celebica"	"nonLC"	"nonLC"	"nonLC___nonLC"
"Pinanga chaiana"	"nonLC"	"nonLC"	"nonLC___nonLC"
"Pinanga cleistantha"	"NA"	"NA"	"NA___NA"
"Pinanga copelandii"	"LC"	"nonLC"	"LC___nonLC"
"Pinanga coronata"	"LC"	"nonLC"	"LC___nonLC"
"Pinanga crassipes"	"LC"	"nonLC"	"LC___nonLC"
"Pinanga cucullata"	"nonLC"	"nonLC"	"nonLC___nonLC"
"Pinanga cupularis"	"nonLC"	"nonLC"	"nonLC___nonLC"
"Pinanga curranii"	"nonLC"	"nonLC"	"nonLC___nonLC"
"Pinanga declinata"	"nonLC"	"nonLC"	"nonLC___nonLC"
"Pinanga decora"	"NA"	"NA"	"NA___NA"
"Pinanga densiflora"	"LC"	"nonLC"	"LC___nonLC"
"Pinanga dicksonii"	"NA"	"NA"	"NA___NA"
"Pinanga disticha"	"LC"	"nonLC"	"LC___nonLC"
"Pinanga dumetosa"	"LC"	"nonLC"	"LC___nonLC"
"Pinanga egregia"	"NA"	"NA"	"NA___NA"
"Pinanga forbesii"	"NA"	"NA"	"NA___NA"
"Pinanga fractiflexa"	"NA"	"NA"	"NA___NA"
"Pinanga furfuracea"	"NA"	"NA"	"NA___NA"
"Pinanga geonomiformis"	"nonLC"	"nonLC"	"nonLC___nonLC"
"Pinanga glauca"	"NA"	"NA"	"NA___NA"
"Pinanga glaucescens"	"LC"	"nonLC"	"LC___nonLC"
"Pinanga glaucifolia"	"nonLC"	"nonLC"	"nonLC___nonLC"
"Pinanga globulifera"	"NA"	"NA"	"NA___NA"
"Pinanga gracilis"	"LC"	"LC"	"LC___LC"
"Pinanga gracillima"	"NA"	"NA"	"NA___NA"
"Pinanga grandijuga"	"NA"	"NA"	"NA___NA"
"Pinanga grandis"	"NA"	"NA"	"NA___NA"
"Pinanga griffithii"	"NA"	"NA"	"NA___NA"
"Pinanga heterophylla"	"nonLC"	"nonLC"	"nonLC___nonLC"
"Pinanga hexasticha"	"NA"	"NA"	"NA___NA"
"Pinanga hookeriana"	"NA"	"NA"	"NA___NA"
"Pinanga humilis"	"nonLC"	"nonLC"	"nonLC___nonLC"
"Pinanga hymenospatha"	"NA"	"NA"	"NA___NA"
"Pinanga inaequalis"	"NA"	"NA"	"NA___NA"
"Pinanga insignis"	"LC"	"nonLC"	"LC___nonLC"
"Pinanga isabelensis"	"nonLC"	"nonLC"	"nonLC___nonLC"
"Pinanga jamariensis"	"NA"	"NA"	"NA___NA"
"Pinanga jambusana"	"NA"	"NA"	"NA___NA"
"Pinanga javana"	"LC"	"nonLC"	"LC___nonLC"
"Pinanga johorensis"	"NA"	"NA"	"NA___NA"
"Pinanga keahii"	"LC"	"nonLC"	"LC___nonLC"
"Pinanga kontumensis"	"nonLC"	"nonLC"	"nonLC___nonLC"
"Pinanga lacei"	"NA"	"NA"	"NA___NA"
"Pinanga latisecta"	"nonLC"	"nonLC"	"nonLC___nonLC"
"Pinanga lepidota"	"LC"	"nonLC"	"LC___nonLC"
"Pinanga ligulata"	"nonLC"	"nonLC"	"nonLC___nonLC"
"Pinanga limbangensis"	"NA"	"NA"	"NA___NA"
"Pinanga limosa"	"LC"	"nonLC"	"LC___nonLC"
"Pinanga macrospadix"	"NA"	"NA"	"NA___NA"
"Pinanga maculata"	"LC"	"nonLC"	"LC___nonLC"
"Pinanga malaiana"	"LC"	"nonLC"	"LC___nonLC"
"Pinanga manii"	"NA"	"NA"	"NA___NA"
"Pinanga megalocarpa"	"NA"	"NA"	"NA___NA"
"Pinanga micholitzii"	"NA"	"NA"	"NA___NA"
"Pinanga minor"	"NA"	"NA"	"NA___NA"
"Pinanga minuta"	"LC"	"nonLC"	"LC___nonLC"
"Pinanga mirabilis"	"LC"	"nonLC"	"LC___nonLC"
"Pinanga modesta"	"nonLC"	"nonLC"	"nonLC___nonLC"
"Pinanga mooreana"	"LC"	"nonLC"	"LC___nonLC"
"Pinanga negrosensis"	"NA"	"NA"	"NA___NA"
"Pinanga nuichuensis"	"nonLC"	"nonLC"	"nonLC___nonLC"
"Pinanga pachycarpa"	"NA"	"NA"	"NA___NA"
"Pinanga pachyphylla"	"nonLC"	"nonLC"	"nonLC___nonLC"
"Pinanga palustris"	"NA"	"NA"	"NA___NA"
"Pinanga pantiensis"	"NA"	"NA"	"NA___NA"
"Pinanga paradoxa"	"nonLC"	"nonLC"	"nonLC___nonLC"
"Pinanga parvula"	"NA"	"NA"	"NA___NA"
"Pinanga patula"	"LC"	"LC"	"LC___LC"
"Pinanga pectinata"	"NA"	"NA"	"NA___NA"
"Pinanga perakensis"	"NA"	"NA"	"NA___NA"
"Pinanga philippinensis"	"LC"	"nonLC"	"LC___nonLC"
"Pinanga pilosa"	"nonLC"	"nonLC"	"nonLC___nonLC"
"Pinanga plicata"	"nonLC"	"nonLC"	"nonLC___nonLC"
"Pinanga polymorpha"	"NA"	"NA"	"NA___NA"
"Pinanga porrecta"	"NA"	"NA"	"NA___NA"
"Pinanga pulchella"	"NA"	"NA"	"NA___NA"
"Pinanga purpurea"	"NA"	"NA"	"NA___NA"
"Pinanga quadrijuga"	"nonLC"	"nonLC"	"nonLC___nonLC"
"Pinanga ridleyana"	"LC"	"nonLC"	"LC___nonLC"
"Pinanga rigida"	"LC"	"nonLC"	"LC___nonLC"
"Pinanga riparia"	"LC"	"nonLC"	"LC___nonLC"
"Pinanga rivularis"	"nonLC"	"nonLC"	"nonLC___nonLC"
"Pinanga rumphiana"	"LC"	"LC"	"LC___LC"
"Pinanga rupestris"	"nonLC"	"nonLC"	"nonLC___nonLC"
"Pinanga salicifolia"	"LC"	"nonLC"	"LC___nonLC"
"Pinanga samarana"	"nonLC"	"nonLC"	"nonLC___nonLC"
"Pinanga sarmentosa"	"NA"	"NA"	"NA___NA"
"Pinanga sclerophylla"	"nonLC"	"nonLC"	"nonLC___nonLC"
"Pinanga scortechinii"	"LC"	"nonLC"	"LC___nonLC"
"Pinanga sembilan"	"NA"	"NA"	"NA___NA"
"Pinanga sessilifolia"	"LC"	"nonLC"	"LC___nonLC"
"Pinanga sibuyanensis"	"NA"	"NA"	"NA___NA"
"Pinanga sierramadreana"	"NA"	"NA"	"NA___NA"
"Pinanga simplicifrons"	"LC"	"LC"	"LC___LC"
"Pinanga singaporensis"	"NA"	"NA"	"NA___NA"
"Pinanga sobolifera"	"nonLC"	"nonLC"	"nonLC___nonLC"
"Pinanga speciosa"	"nonLC"	"nonLC"	"nonLC___nonLC"
"Pinanga stricta"	"nonLC"	"nonLC"	"nonLC___nonLC"
"Pinanga stylosa"	"LC"	"nonLC"	"LC___nonLC"
"Pinanga subintegra"	"LC"	"nonLC"	"LC___nonLC"
"Pinanga subruminata"	"nonLC"	"nonLC"	"nonLC___nonLC"
"Pinanga sylvestris"	"LC"	"LC"	"LC___LC"
"Pinanga tashiroi"	"nonLC"	"nonLC"	"nonLC___nonLC"
"Pinanga tenacinervis"	"nonLC"	"nonLC"	"nonLC___nonLC"
"Pinanga tenella"	"LC"	"nonLC"	"LC___nonLC"
"Pinanga tomentella"	"nonLC"	"nonLC"	"nonLC___nonLC"
"Pinanga tomentosa"	"nonLC"	"nonLC"	"nonLC___nonLC"
"Pinanga trichoneura"	"LC"	"nonLC"	"LC___nonLC"
"Pinanga uncinata"	"NA"	"NA"	"NA___NA"
"Pinanga urdanetensis"	"NA"	"NA"	"NA___NA"
"Pinanga urosperma"	"NA"	"NA"	"NA___NA"
"Pinanga variegata"	"LC"	"nonLC"	"LC___nonLC"
"Pinanga veitchii"	"nonLC"	"nonLC"	"nonLC___nonLC"
"Pinanga versicolor"	"nonLC"	"nonLC"	"nonLC___nonLC"
"Pinanga watanaiana"	"NA"	"NA"	"NA___NA"
"Pinanga woodiana"	"nonLC"	"nonLC"	"nonLC___nonLC"
"Pinanga yassinii"	"nonLC"	"nonLC"	"nonLC___nonLC"
"Plectocomia assamica"	"NA"	"NA"	"NA___NA"
"Plectocomia billitonensis"	"NA"	"NA"	"NA___NA"
"Plectocomia bractealis"	"NA"	"NA"	"NA___NA"
"Plectocomia dransfieldiana"	"nonLC"	"nonLC"	"nonLC___nonLC"
"Plectocomia elmeri"	"nonLC"	"nonLC"	"nonLC___nonLC"
"Plectocomia elongata"	"LC"	"LC"	"LC___LC"
"Plectocomia himalayana"	"LC"	"LC"	"LC___LC"
"Plectocomia khasyana"	"NA"	"NA"	"NA___NA"
"Plectocomia longistigma"	"NA"	"NA"	"NA___NA"
"Plectocomia lorzingii"	"NA"	"NA"	"NA___NA"
"Plectocomia macrostachya"	"NA"	"NA"	"NA___NA"
"Plectocomia microstachys"	"nonLC"	"nonLC"	"nonLC___nonLC"
"Plectocomia mulleri"	"LC"	"LC"	"LC___LC"
"Plectocomia pierreana"	"LC"	"LC"	"LC___LC"
"Plectocomia pygmaea"	"NA"	"NA"	"NA___NA"
"Plectocomiopsis corneri"	"NA"	"NA"	"NA___NA"
"Plectocomiopsis geminiflora"	"LC"	"LC"	"LC___LC"
"Plectocomiopsis mira"	"LC"	"LC"	"LC___LC"
"Plectocomiopsis songthanhensis"	"nonLC"	"nonLC"	"nonLC___nonLC"
"Plectocomiopsis triquetra"	"LC"	"LC"	"LC___LC"
"Plectocomiopsis wrayi"	"NA"	"NA"	"NA___NA"
"Podococcus acaulis"	"LC"	"nonLC"	"LC___nonLC"
"Podococcus barteri"	"LC"	"LC"	"LC___LC"
"Ponapea hentyi"	"nonLC"	"nonLC"	"nonLC___nonLC"
"Ponapea hosinoi"	"NA"	"NA"	"NA___NA"
"Ponapea ledermanniana"	"NA"	"NA"	"NA___NA"
"Ponapea palauensis"	"NA"	"NA"	"NA___NA"
"Prestoea acuminata"	"LC"	"LC"	"LC___LC"
"Prestoea carderi"	"LC"	"LC"	"LC___LC"
"Prestoea decurrens"	"LC"	"LC"	"LC___LC"
"Prestoea ensiformis"	"LC"	"LC"	"LC___LC"
"Prestoea longepetiolata"	"LC"	"LC"	"LC___LC"
"Prestoea pubens"	"LC"	"nonLC"	"LC___nonLC"
"Prestoea pubigera"	"LC"	"nonLC"	"LC___nonLC"
"Prestoea schultzeana"	"LC"	"LC"	"LC___LC"
"Prestoea simplicifolia"	"nonLC"	"nonLC"	"nonLC___nonLC"
"Prestoea tenuiramosa"	"LC"	"nonLC"	"LC___nonLC"
"Pritchardia arecina"	"NA"	"NA"	"NA___NA"
"Pritchardia bakeri"	"nonLC"	"nonLC"	"nonLC___nonLC"
"Pritchardia beccariana"	"nonLC"	"nonLC"	"nonLC___nonLC"
"Pritchardia flynnii"	"nonLC"	"nonLC"	"nonLC___nonLC"
"Pritchardia forbesiana"	"nonLC"	"nonLC"	"nonLC___nonLC"
"Pritchardia glabrata"	"nonLC"	"nonLC"	"nonLC___nonLC"
"Pritchardia gordonii"	"NA"	"NA"	"NA___NA"
"Pritchardia hardyi"	"NA"	"NA"	"NA___NA"
"Pritchardia hillebrandii"	"nonLC"	"nonLC"	"nonLC___nonLC"
"Pritchardia kaalae"	"NA"	"NA"	"NA___NA"
"Pritchardia kahukuensis"	"nonLC"	"nonLC"	"nonLC___nonLC"
"Pritchardia lanigera"	"NA"	"NA"	"NA___NA"
"Pritchardia lowreyana"	"NA"	"NA"	"NA___NA"
"Pritchardia maideniana"	"nonLC"	"nonLC"	"nonLC___nonLC"
"Pritchardia martii"	"nonLC"	"nonLC"	"nonLC___nonLC"
"Pritchardia minor"	"nonLC"	"nonLC"	"nonLC___nonLC"
"Pritchardia mitiaroana"	"NA"	"NA"	"NA___NA"
"Pritchardia munroi"	"nonLC"	"nonLC"	"nonLC___nonLC"
"Pritchardia napaliensis"	"nonLC"	"nonLC"	"nonLC___nonLC"
"Pritchardia pacifica"	"nonLC"	"nonLC"	"nonLC___nonLC"
"Pritchardia perlmanii"	"NA"	"NA"	"NA___NA"
"Pritchardia remota"	"NA"	"NA"	"NA___NA"
"Pritchardia schattaueri"	"NA"	"NA"	"NA___NA"
"Pritchardia thurstonii"	"nonLC"	"nonLC"	"nonLC___nonLC"
"Pritchardia viscosa"	"NA"	"NA"	"NA___NA"
"Pritchardia vuylstekeana"	"NA"	"NA"	"NA___NA"
"Pritchardia waialealeana"	"nonLC"	"nonLC"	"nonLC___nonLC"
"Pritchardia woodii"	"NA"	"NA"	"NA___NA"
"Pseudophoenix ekmanii"	"nonLC"	"nonLC"	"nonLC___nonLC"
"Pseudophoenix lediniana"	"nonLC"	"nonLC"	"nonLC___nonLC"
"Pseudophoenix sargentii"	"LC"	"LC"	"LC___LC"
"Pseudophoenix vinifera"	"LC"	"nonLC"	"LC___nonLC"
"Ptychococcus lepidotus"	"LC"	"nonLC"	"LC___nonLC"
"Ptychococcus paradoxus"	"LC"	"LC"	"LC___LC"
"Ptychosperma ambiguum"	"NA"	"NA"	"NA___NA"
"Ptychosperma buabe"	"nonLC"	"nonLC"	"nonLC___nonLC"
"Ptychosperma burretianum"	"nonLC"	"nonLC"	"nonLC___nonLC"
"Ptychosperma caryotoides"	"LC"	"nonLC"	"LC___nonLC"
"Ptychosperma cuneatum"	"nonLC"	"nonLC"	"nonLC___nonLC"
"Ptychosperma elegans"	"NA"	"NA"	"NA___NA"
"Ptychosperma furcatum"	"nonLC"	"nonLC"	"nonLC___nonLC"
"Ptychosperma gracile"	"nonLC"	"nonLC"	"nonLC___nonLC"
"Ptychosperma hartmannii"	"NA"	"NA"	"NA___NA"
"Ptychosperma lauterbachii"	"LC"	"nonLC"	"LC___nonLC"
"Ptychosperma lineare"	"nonLC"	"nonLC"	"nonLC___nonLC"
"Ptychosperma macarthurii"	"LC"	"LC"	"LC___LC"
"Ptychosperma macrocerum"	"NA"	"NA"	"NA___NA"
"Ptychosperma mambare"	"nonLC"	"nonLC"	"nonLC___nonLC"
"Ptychosperma microcarpum"	"LC"	"LC"	"LC___LC"
"Ptychosperma mooreanum"	"nonLC"	"nonLC"	"nonLC___nonLC"
"Ptychosperma nicolai"	"NA"	"NA"	"NA___NA"
"Ptychosperma praemorsum"	"NA"	"NA"	"NA___NA"
"Ptychosperma propinquum"	"LC"	"nonLC"	"LC___nonLC"
"Ptychosperma pullenii"	"nonLC"	"nonLC"	"nonLC___nonLC"
"Ptychosperma ramosissimum"	"nonLC"	"nonLC"	"nonLC___nonLC"
"Ptychosperma rosselense"	"nonLC"	"nonLC"	"nonLC___nonLC"
"Ptychosperma salomonense"	"LC"	"nonLC"	"LC___nonLC"
"Ptychosperma sanderianum"	"NA"	"NA"	"NA___NA"
"Ptychosperma schefferi"	"nonLC"	"nonLC"	"nonLC___nonLC"
"Ptychosperma streimannii"	"nonLC"	"nonLC"	"nonLC___nonLC"
"Ptychosperma tagulense"	"nonLC"	"nonLC"	"nonLC___nonLC"
"Ptychosperma vestitum"	"nonLC"	"nonLC"	"nonLC___nonLC"
"Ptychosperma waitianum"	"nonLC"	"nonLC"	"nonLC___nonLC"
"Raphia africana"	"nonLC"	"nonLC"	"nonLC___nonLC"
"Raphia australis"	"nonLC"	"nonLC"	"nonLC___nonLC"
"Raphia farinifera"	"LC"	"LC"	"LC___LC"
"Raphia gentiliana"	"LC"	"nonLC"	"LC___nonLC"
"Raphia hookeri"	"LC"	"LC"	"LC___LC"
"Raphia laurentii"	"LC"	"nonLC"	"LC___nonLC"
"Raphia longiflora"	"NA"	"NA"	"NA___NA"
"Raphia mambillensis"	"LC"	"LC"	"LC___LC"
"Raphia mannii"	"NA"	"NA"	"NA___NA"
"Raphia matombe"	"NA"	"NA"	"NA___NA"
"Raphia monbuttorum"	"LC"	"nonLC"	"LC___nonLC"
"Raphia palma-pinus"	"LC"	"LC"	"LC___LC"
"Raphia regalis"	"LC"	"LC"	"LC___LC"
"Raphia rostrata"	"NA"	"NA"	"NA___NA"
"Raphia ruwenzorica"	"nonLC"	"nonLC"	"nonLC___nonLC"
"Raphia sese"	"NA"	"NA"	"NA___NA"
"Raphia sudanica"	"LC"	"LC"	"LC___LC"
"Raphia taedigera"	"LC"	"LC"	"LC___LC"
"Raphia textilis"	"NA"	"NA"	"NA___NA"
"Raphia vinifera"	"LC"	"LC"	"LC___LC"
"Ravenea albicans"	"nonLC"	"nonLC"	"nonLC___nonLC"
"Ravenea beentjei"	"nonLC"	"nonLC"	"nonLC___nonLC"
"Ravenea declivium"	"NA"	"NA"	"NA___NA"
"Ravenea delicatula"	"nonLC"	"nonLC"	"nonLC___nonLC"
"Ravenea dransfieldii"	"nonLC"	"nonLC"	"nonLC___nonLC"
"Ravenea glauca"	"nonLC"	"nonLC"	"nonLC___nonLC"
"Ravenea hildebrandtii"	"nonLC"	"nonLC"	"nonLC___nonLC"
"Ravenea hypoleuca"	"nonLC"	"nonLC"	"nonLC___nonLC"
"Ravenea julietiae"	"nonLC"	"nonLC"	"nonLC___nonLC"
"Ravenea krociana"	"nonLC"	"nonLC"	"nonLC___nonLC"
"Ravenea lakatra"	"nonLC"	"nonLC"	"nonLC___nonLC"
"Ravenea latisecta"	"nonLC"	"nonLC"	"nonLC___nonLC"
"Ravenea louvelii"	"nonLC"	"nonLC"	"nonLC___nonLC"
"Ravenea madagascariensis"	"LC"	"LC"	"LC___LC"
"Ravenea moorei"	"nonLC"	"nonLC"	"nonLC___nonLC"
"Ravenea musicalis"	"nonLC"	"nonLC"	"nonLC___nonLC"
"Ravenea nana"	"nonLC"	"nonLC"	"nonLC___nonLC"
"Ravenea rivularis"	"nonLC"	"nonLC"	"nonLC___nonLC"
"Ravenea robustior"	"nonLC"	"nonLC"	"nonLC___nonLC"
"Ravenea sambiranensis"	"LC"	"LC"	"LC___LC"
"Ravenea xerophila"	"nonLC"	"nonLC"	"nonLC___nonLC"
"Reinhardtia elegans"	"nonLC"	"nonLC"	"nonLC___nonLC"
"Reinhardtia gracilis"	"LC"	"LC"	"LC___LC"
"Reinhardtia koschnyana"	"LC"	"LC"	"LC___LC"
"Reinhardtia latisecta"	"LC"	"LC"	"LC___LC"
"Reinhardtia paiewonskiana"	"nonLC"	"nonLC"	"nonLC___nonLC"
"Reinhardtia simplex"	"LC"	"LC"	"LC___LC"
"Rhapidophyllum hystrix"	"LC"	"LC"	"LC___LC"
"Rhapis evansii"	"nonLC"	"nonLC"	"nonLC___nonLC"
"Rhapis excelsa"	"LC"	"LC"	"LC___LC"
"Rhapis gracilis"	"LC"	"nonLC"	"LC___nonLC"
"Rhapis humilis"	"LC"	"nonLC"	"LC___nonLC"
"Rhapis kebangensis"	"nonLC"	"nonLC"	"nonLC___nonLC"
"Rhapis laosensis"	"LC"	"LC"	"LC___LC"
"Rhapis micrantha"	"nonLC"	"nonLC"	"nonLC___nonLC"
"Rhapis puhuongensis"	"nonLC"	"nonLC"	"nonLC___nonLC"
"Rhapis robusta"	"nonLC"	"nonLC"	"nonLC___nonLC"
"Rhapis subtilis"	"LC"	"nonLC"	"LC___nonLC"
"Rhapis vidalii"	"nonLC"	"nonLC"	"nonLC___nonLC"
"Rhopaloblaste augusta"	"NA"	"NA"	"NA___NA"
"Rhopaloblaste ceramica"	"LC"	"nonLC"	"LC___nonLC"
"Rhopaloblaste elegans"	"NA"	"NA"	"NA___NA"
"Rhopaloblaste gideonii"	"nonLC"	"nonLC"	"nonLC___nonLC"
"Rhopaloblaste ledermanniana"	"LC"	"LC"	"LC___LC"
"Rhopaloblaste singaporensis"	"NA"	"NA"	"NA___NA"
"Rhopalostylis baueri"	"LC"	"nonLC"	"LC___nonLC"
"Rhopalostylis sapida"	"LC"	"LC"	"LC___LC"
"Roscheria melanochaetes"	"nonLC"	"nonLC"	"nonLC___nonLC"
"Roystonea altissima"	"NA"	"NA"	"NA___NA"
"Roystonea borinquena"	"nonLC"	"nonLC"	"nonLC___nonLC"
"Roystonea dunlapiana"	"LC"	"LC"	"LC___LC"
"Roystonea lenis"	"NA"	"NA"	"NA___NA"
"Roystonea maisiana"	"NA"	"NA"	"NA___NA"
"Roystonea oleracea"	"LC"	"LC"	"LC___LC"
"Roystonea princeps"	"nonLC"	"nonLC"	"nonLC___nonLC"
"Roystonea regia"	"LC"	"LC"	"LC___LC"
"Roystonea violacea"	"NA"	"NA"	"NA___NA"
"Sabal bermudana"	"nonLC"	"nonLC"	"nonLC___nonLC"
"Sabal causiarum"	"nonLC"	"nonLC"	"nonLC___nonLC"
"Sabal domingensis"	"nonLC"	"nonLC"	"nonLC___nonLC"
"Sabal etonia"	"NA"	"NA"	"NA___NA"
"Sabal gretherae"	"nonLC"	"nonLC"	"nonLC___nonLC"
"Sabal maritima"	"NA"	"NA"	"NA___NA"
"Sabal mauritiiformis"	"LC"	"LC"	"LC___LC"
"Sabal mexicana"	"LC"	"LC"	"LC___LC"
"Sabal minor"	"LC"	"LC"	"LC___LC"
"Sabal palmetto"	"LC"	"LC"	"LC___LC"
"Sabal pumos"	"LC"	"nonLC"	"LC___nonLC"
"Sabal rosei"	"LC"	"nonLC"	"LC___nonLC"
"Sabal uresana"	"nonLC"	"nonLC"	"nonLC___nonLC"
"Sabal yapa"	"LC"	"LC"	"LC___LC"
"Sabinaria magnifica"	"nonLC"	"nonLC"	"nonLC___nonLC"
"Salacca acehensis"	"nonLC"	"nonLC"	"nonLC___nonLC"
"Salacca affinis"	"LC"	"nonLC"	"LC___nonLC"
"Salacca bakeriana"	"NA"	"NA"	"NA___NA"
"Salacca clemensiana"	"LC"	"nonLC"	"LC___nonLC"
"Salacca dolicholepis"	"nonLC"	"nonLC"	"nonLC___nonLC"
"Salacca dransfieldiana"	"LC"	"nonLC"	"LC___nonLC"
"Salacca flabellata"	"NA"	"NA"	"NA___NA"
"Salacca glabrescens"	"LC"	"nonLC"	"LC___nonLC"
"Salacca graciliflora"	"NA"	"NA"	"NA___NA"
"Salacca griffithii"	"NA"	"NA"	"NA___NA"
"Salacca magnifica"	"nonLC"	"nonLC"	"nonLC___nonLC"
"Salacca minuta"	"NA"	"NA"	"NA___NA"
"Salacca multiflora"	"NA"	"NA"	"NA___NA"
"Salacca ramosiana"	"nonLC"	"nonLC"	"nonLC___nonLC"
"Salacca rupicola"	"nonLC"	"nonLC"	"nonLC___nonLC"
"Salacca sarawakensis"	"nonLC"	"nonLC"	"nonLC___nonLC"
"Salacca secunda"	"LC"	"nonLC"	"LC___nonLC"
"Salacca stolonifera"	"NA"	"NA"	"NA___NA"
"Salacca sumatrana"	"nonLC"	"nonLC"	"nonLC___nonLC"
"Salacca vermicularis"	"LC"	"nonLC"	"LC___nonLC"
"Salacca wallichiana"	"LC"	"LC"	"LC___LC"
"Salacca zalacca"	"LC"	"nonLC"	"LC___nonLC"
"Saribus brevifolius"	"nonLC"	"nonLC"	"nonLC___nonLC"
"Saribus chocolatinus"	"nonLC"	"nonLC"	"nonLC___nonLC"
"Saribus jeanneneyi"	"nonLC"	"nonLC"	"nonLC___nonLC"
"Saribus merrillii"	"NA"	"NA"	"NA___NA"
"Saribus papuanus"	"NA"	"NA"	"NA___NA"
"Saribus rotundifolius"	"LC"	"LC"	"LC___LC"
"Saribus surru"	"nonLC"	"nonLC"	"nonLC___nonLC"
"Saribus tothur"	"nonLC"	"nonLC"	"nonLC___nonLC"
"Saribus woodfordii"	"LC"	"nonLC"	"LC___nonLC"
"Satakentia liukiuensis"	"nonLC"	"nonLC"	"nonLC___nonLC"
"Satranala decussilvae"	"nonLC"	"nonLC"	"nonLC___nonLC"
"Schippia concolor"	"LC"	"nonLC"	"LC___nonLC"
"Sclerosperma mannii"	"LC"	"LC"	"LC___LC"
"Sclerosperma profizianum"	"LC"	"nonLC"	"LC___nonLC"
"Sclerosperma walkeri"	"nonLC"	"nonLC"	"nonLC___nonLC"
"Serenoa repens"	"LC"	"LC"	"LC___LC"
"Socratea exorrhiza"	"LC"	"LC"	"LC___LC"
"Socratea hecatonandra"	"nonLC"	"nonLC"	"nonLC___nonLC"
"Socratea karstenii"	"NA"	"NA"	"NA___NA"
"Socratea rostrata"	"LC"	"LC"	"LC___LC"
"Socratea salazarii"	"LC"	"LC"	"LC___LC"
"Sommieria leucophylla"	"LC"	"nonLC"	"LC___nonLC"
"Syagrus allagopteroides"	"LC"	"LC"	"LC___LC"
"Syagrus amara"	"nonLC"	"nonLC"	"nonLC___nonLC"
"Syagrus angustifolia"	"nonLC"	"nonLC"	"nonLC___nonLC"
"Syagrus botryophora"	"LC"	"LC"	"LC___LC"
"Syagrus caerulescens"	"nonLC"	"nonLC"	"nonLC___nonLC"
"Syagrus campestris"	"LC"	"nonLC"	"LC___nonLC"
"Syagrus campylospatha"	"LC"	"nonLC"	"LC___nonLC"
"Syagrus cardenasii"	"LC"	"nonLC"	"LC___nonLC"
"Syagrus cearensis"	"nonLC"	"nonLC"	"nonLC___nonLC"
"Syagrus cerqueirana"	"LC"	"nonLC"	"LC___nonLC"
"Syagrus cocoides"	"LC"	"LC"	"LC___LC"
"Syagrus comosa"	"LC"	"LC"	"LC___LC"
"Syagrus coronata"	"LC"	"LC"	"LC___LC"
"Syagrus deflexa"	"nonLC"	"nonLC"	"nonLC___nonLC"
"Syagrus duartei"	"nonLC"	"nonLC"	"nonLC___nonLC"
"Syagrus emasensis"	"nonLC"	"nonLC"	"nonLC___nonLC"
"Syagrus evansiana"	"LC"	"nonLC"	"LC___nonLC"
"Syagrus flexuosa"	"LC"	"LC"	"LC___LC"
"Syagrus glaucescens"	"nonLC"	"nonLC"	"nonLC___nonLC"
"Syagrus glazioviana"	"LC"	"LC"	"LC___LC"
"Syagrus gouveiana"	"nonLC"	"nonLC"	"nonLC___nonLC"
"Syagrus graminifolia"	"NA"	"NA"	"NA___NA"
"Syagrus guimaraesensis"	"nonLC"	"nonLC"	"nonLC___nonLC"
"Syagrus harleyi"	"LC"	"nonLC"	"LC___nonLC"
"Syagrus hoehnei"	"LC"	"nonLC"	"LC___nonLC"
"Syagrus inajai"	"LC"	"LC"	"LC___LC"
"Syagrus insignis"	"nonLC"	"nonLC"	"nonLC___nonLC"
"Syagrus itacambirana"	"nonLC"	"nonLC"	"nonLC___nonLC"
"Syagrus itapebiensis"	"nonLC"	"nonLC"	"nonLC___nonLC"
"Syagrus kellyana"	"nonLC"	"nonLC"	"nonLC___nonLC"
"Syagrus lilliputiana"	"LC"	"nonLC"	"LC___nonLC"
"Syagrus loefgrenii"	"LC"	"nonLC"	"LC___nonLC"
"Syagrus longipedunculata"	"nonLC"	"nonLC"	"nonLC___nonLC"
"Syagrus lorenzoniorum"	"LC"	"nonLC"	"LC___nonLC"
"Syagrus macrocarpa"	"nonLC"	"nonLC"	"nonLC___nonLC"
"Syagrus mendanhensis"	"nonLC"	"nonLC"	"nonLC___nonLC"
"Syagrus menzeliana"	"nonLC"	"nonLC"	"nonLC___nonLC"
"Syagrus microphylla"	"LC"	"nonLC"	"LC___nonLC"
"Syagrus minor"	"nonLC"	"nonLC"	"nonLC___nonLC"
"Syagrus oleracea"	"LC"	"LC"	"LC___LC"
"Syagrus orinocensis"	"LC"	"LC"	"LC___LC"
"Syagrus petraea"	"LC"	"LC"	"LC___LC"
"Syagrus picrophylla"	"nonLC"	"nonLC"	"nonLC___nonLC"
"Syagrus pleioclada"	"LC"	"nonLC"	"LC___nonLC"
"Syagrus pleiocladoides"	"nonLC"	"nonLC"	"nonLC___nonLC"
"Syagrus pompeoi"	"NA"	"NA"	"NA___NA"
"Syagrus procumbens"	"nonLC"	"nonLC"	"nonLC___nonLC"
"Syagrus pseudococos"	"LC"	"LC"	"LC___LC"
"Syagrus romanzoffiana"	"LC"	"LC"	"LC___LC"
"Syagrus rupicola"	"nonLC"	"nonLC"	"nonLC___nonLC"
"Syagrus ruschiana"	"nonLC"	"nonLC"	"nonLC___nonLC"
"Syagrus sancona"	"LC"	"LC"	"LC___LC"
"Syagrus santosii"	"nonLC"	"nonLC"	"nonLC___nonLC"
"Syagrus schizophylla"	"LC"	"LC"	"LC___LC"
"Syagrus smithii"	"LC"	"LC"	"LC___LC"
"Syagrus stenopetala"	"nonLC"	"nonLC"	"nonLC___nonLC"
"Syagrus stratincola"	"LC"	"nonLC"	"LC___nonLC"
"Syagrus vagans"	"LC"	"nonLC"	"LC___nonLC"
"Syagrus vermicularis"	"nonLC"	"nonLC"	"nonLC___nonLC"
"Syagrus weddelliana"	"nonLC"	"nonLC"	"nonLC___nonLC"
"Syagrus werdermannii"	"nonLC"	"nonLC"	"nonLC___nonLC"
"Syagrus yungasensis"	"nonLC"	"nonLC"	"nonLC___nonLC"
"Synechanthus dasystachys"	"NA"	"NA"	"NA___NA"
"Synechanthus fibrosus"	"LC"	"LC"	"LC___LC"
"Synechanthus warscewiczianus"	"LC"	"LC"	"LC___LC"
"Tahina spectabilis"	"nonLC"	"nonLC"	"nonLC___nonLC"
"Tectiphiala ferox"	"NA"	"NA"	"NA___NA"
"Thrinax excelsa"	"NA"	"NA"	"NA___NA"
"Thrinax parviflora"	"NA"	"NA"	"NA___NA"
"Thrinax radiata"	"LC"	"LC"	"LC___LC"
"Trachycarpus fortunei"	"LC"	"LC"	"LC___LC"
"Trachycarpus geminisectus"	"nonLC"	"nonLC"	"nonLC___nonLC"
"Trachycarpus latisectus"	"NA"	"NA"	"NA___NA"
"Trachycarpus martianus"	"LC"	"nonLC"	"LC___nonLC"
"Trachycarpus nanus"	"nonLC"	"nonLC"	"nonLC___nonLC"
"Trachycarpus oreophilus"	"nonLC"	"nonLC"	"nonLC___nonLC"
"Trachycarpus princeps"	"nonLC"	"nonLC"	"nonLC___nonLC"
"Trachycarpus ravenii"	"NA"	"NA"	"NA___NA"
"Trachycarpus takil"	"NA"	"NA"	"NA___NA"
"Trachycarpus ukhrulensis"	"NA"	"NA"	"NA___NA"
"Trithrinax brasiliensis"	"LC"	"nonLC"	"LC___nonLC"
"Trithrinax campestris"	"LC"	"nonLC"	"LC___nonLC"
"Trithrinax schizophylla"	"LC"	"LC"	"LC___LC"
"Veitchia arecina"	"nonLC"	"nonLC"	"nonLC___nonLC"
"Veitchia filifera"	"LC"	"LC"	"LC___LC"
"Veitchia joannis"	"LC"	"LC"	"LC___LC"
"Veitchia lepidota"	"NA"	"NA"	"NA___NA"
"Veitchia metiti"	"NA"	"NA"	"NA___NA"
"Veitchia pachyclada"	"nonLC"	"nonLC"	"nonLC___nonLC"
"Veitchia simulans"	"NA"	"NA"	"NA___NA"
"Veitchia spiralis"	"NA"	"NA"	"NA___NA"
"Veitchia subdisticha"	"nonLC"	"nonLC"	"nonLC___nonLC"
"Veitchia vitiensis"	"LC"	"LC"	"LC___LC"
"Veitchia winin"	"NA"	"NA"	"NA___NA"
"Verschaffeltia splendida"	"nonLC"	"nonLC"	"nonLC___nonLC"
"Voanioala gerardii"	"nonLC"	"nonLC"	"nonLC___nonLC"
"Wallaceodoxa raja-ampat"	"NA"	"NA"	"NA___NA"
"Wallichia caryotoides"	"LC"	"LC"	"LC___LC"
"Wallichia disticha"	"LC"	"LC"	"LC___LC"
"Wallichia gracilis"	"LC"	"LC"	"LC___LC"
"Wallichia lidiae"	"NA"	"NA"	"NA___NA"
"Wallichia marianneae"	"NA"	"NA"	"NA___NA"
"Wallichia nana"	"NA"	"NA"	"NA___NA"
"Wallichia oblongifolia"	"LC"	"LC"	"LC___LC"
"Wallichia triandra"	"NA"	"NA"	"NA___NA"
"Washingtonia filifera"	"LC"	"LC"	"LC___LC"
"Washingtonia robusta"	"LC"	"LC"	"LC___LC"
"Welfia alfredii"	"nonLC"	"nonLC"	"nonLC___nonLC"
"Welfia regia"	"NA"	"NA"	"NA___NA"
"Wendlandiella gracilis"	"LC"	"LC"	"LC___LC"
"Wettinia aequalis"	"LC"	"LC"	"LC___LC"
"Wettinia aequatorialis"	"nonLC"	"nonLC"	"nonLC___nonLC"
"Wettinia anomala"	"LC"	"nonLC"	"LC___nonLC"
"Wettinia augusta"	"LC"	"LC"	"LC___LC"
"Wettinia castanea"	"nonLC"	"nonLC"	"nonLC___nonLC"
"Wettinia disticha"	"nonLC"	"nonLC"	"nonLC___nonLC"
"Wettinia drudei"	"LC"	"LC"	"LC___LC"
"Wettinia fascicularis"	"LC"	"nonLC"	"LC___nonLC"
"Wettinia hirsuta"	"nonLC"	"nonLC"	"nonLC___nonLC"
"Wettinia kalbreyeri"	"LC"	"LC"	"LC___LC"
"Wettinia lanata"	"nonLC"	"nonLC"	"nonLC___nonLC"
"Wettinia longipetala"	"LC"	"nonLC"	"LC___nonLC"
"Wettinia maynensis"	"LC"	"LC"	"LC___LC"
"Wettinia microcarpa"	"nonLC"	"nonLC"	"nonLC___nonLC"
"Wettinia minima"	"nonLC"	"nonLC"	"nonLC___nonLC"
"Wettinia oxycarpa"	"LC"	"nonLC"	"LC___nonLC"
"Wettinia panamensis"	"nonLC"	"nonLC"	"nonLC___nonLC"
"Wettinia praemorsa"	"LC"	"LC"	"LC___LC"
"Wettinia quinaria"	"LC"	"LC"	"LC___LC"
"Wettinia radiata"	"LC"	"nonLC"	"LC___nonLC"
"Wettinia verruculosa"	"LC"	"nonLC"	"LC___nonLC"
"Wodyetia bifurcata"	"LC"	"nonLC"	"LC___nonLC"
"Zombia antillarum"	"LC"	"nonLC"	"LC___nonLC"
